metal_results_id,edition,edition_id,country_noc,country,athletes_num,gold_num,silver_num,bronze_num,total_num
62USA,2022 Winter Olympics,62,USA,United States,124,12,48,12,72
61USA,2020 Summer Olympics,61,USA,United States,440,113,109,75,297
60USA,2018 Winter Olympics,60,USA,United States,136,36,9,23,68
59USA,2016 Summer Olympics,59,USA,United States,365,139,54,71,264
58USA,2014 Winter Olympics,58,USA,United States,122,10,38,18,66
54USA,2012 Summer Olympics,54,USA,United States,309,153,55,47,255
57USA,2010 Winter Olympics,57,USA,United States,126,12,64,22,98
53USA,2008 Summer Olympics,53,USA,United States,401,131,110,82,323
49USA,2006 Winter Olympics,49,USA,United States,122,9,11,34,54
26USA,2004 Summer Olympics,26,USA,United States,343,123,76,72,271
47USA,2002 Winter Olympics,47,USA,United States,106,11,58,15,84
25USA,2000 Summer Olympics,25,USA,United States,410,131,70,52,253
46USA,1998 Winter Olympics,46,USA,United States,123,25,4,5,34
24USA,1996 Summer Olympics,24,USA,United States,470,163,48,52,263
45USA,1994 Winter Olympics,45,USA,United States,74,6,9,6,21
44USA,1992 Winter Olympics,44,USA,United States,119,5,8,2,15
23USA,1992 Summer Olympics,23,USA,United States,384,89,50,85,224
43USA,1988 Winter Olympics,43,USA,United States,119,2,1,4,7
22USA,1988 Summer Olympics,22,USA,United States,425,89,69,54,212
42USA,1984 Winter Olympics,42,USA,United States,78,4,5,0,9
21USA,1984 Summer Olympics,21,USA,United States,540,193,116,50,359
41USA,1980 Winter Olympics,41,USA,United States,67,25,4,2,31
40USA,1976 Winter Olympics,40,USA,United States,90,3,3,5,11
19USA,1976 Summer Olympics,19,USA,United States,310,74,60,36,170
39USA,1972 Winter Olympics,39,USA,United States,87,3,21,3,27
18USA,1972 Summer Olympics,18,USA,United States,316,72,61,43,176
38USA,1968 Winter Olympics,38,USA,United States,81,1,5,1,7
17USA,1968 Summer Olympics,17,USA,United States,293,105,32,35,172
37USA,1964 Winter Olympics,37,USA,United States,68,1,2,5,8
16USA,1964 Summer Olympics,16,USA,United States,303,99,39,37,175
36USA,1960 Winter Olympics,36,USA,United States,63,19,4,4,27
15USA,1960 Summer Olympics,15,USA,United States,210,85,23,21,129
48USA,1956 Equestrian Olympics,48,USA,United States,5,0,0,0,0
35USA,1956 Winter Olympics,35,USA,United States,52,2,20,5,27
14USA,1956 Summer Olympics,14,USA,United States,259,69,43,24,136
34USA,1952 Winter Olympics,34,USA,United States,52,4,25,1,30
13USA,1952 Summer Olympics,13,USA,United States,238,93,27,30,150
33USA,1948 Winter Olympics,33,USA,United States,68,6,4,6,16
12USA,1948 Summer Olympics,12,USA,United States,323,98,30,35,163
32USA,1936 Winter Olympics,32,USA,United States,40,2,0,16,18
11USA,1936 Summer Olympics,11,USA,United States,317,61,33,17,111
31USA,1932 Winter Olympics,31,USA,United States,88,10,21,3,34
10USA,1932 Summer Olympics,10,USA,United States,479,100,47,68,215
30USA,1928 Winter Olympics,30,USA,United States,20,6,6,2,14
9USA,1928 Summer Olympics,9,USA,United States,274,58,29,17,104
29USA,1924 Winter Olympics,29,USA,United States,20,1,11,1,13
8USA,1924 Summer Olympics,8,USA,United States,285,116,36,52,204
7USA,1920 Summer Olympics,7,USA,United States,285,116,45,38,199
6USA,1912 Summer Olympics,6,USA,United States,183,46,25,36,107
5USA,1908 Summer Olympics,5,USA,United States,119,34,16,15,65
3USA,1904 Summer Olympics,3,USA,United States,1221,138,149,135,422
2USA,1900 Summer Olympics,2,USA,United States,95,28,15,21,64
1USA,1896 Summer Olympics,1,USA,United States,20,11,7,2,20
62SWE,2022 Winter Olympics,62,SWE,Sweden,65,15,6,13,34
61SWE,2020 Summer Olympics,61,SWE,Sweden,78,6,28,0,34
60SWE,2018 Winter Olympics,60,SWE,Sweden,70,14,17,1,32
59SWE,2016 Summer Olympics,59,SWE,Sweden,100,2,27,3,32
58SWE,2014 Winter Olympics,58,SWE,Sweden,54,8,35,12,55
54SWE,2012 Summer Olympics,54,SWE,Sweden,85,2,18,3,23
57SWE,2010 Winter Olympics,57,SWE,Sweden,59,12,3,4,19
53SWE,2008 Summer Olympics,53,SWE,Sweden,71,0,5,2,7
49SWE,2006 Winter Olympics,49,SWE,Sweden,54,36,21,8,65
26SWE,2004 Summer Olympics,26,SWE,Sweden,56,5,5,2,12
47SWE,2002 Winter Olympics,47,SWE,Sweden,51,0,2,24,26
25SWE,2000 Summer Olympics,25,SWE,Sweden,94,4,20,8,32
46SWE,1998 Winter Olympics,46,SWE,Sweden,75,0,2,5,7
24SWE,1996 Summer Olympics,24,SWE,Sweden,105,3,23,5,31
45SWE,1994 Winter Olympics,45,SWE,Sweden,42,24,1,0,25
44SWE,1992 Winter Olympics,44,SWE,Sweden,65,1,0,6,7
23SWE,1992 Summer Olympics,23,SWE,Sweden,121,1,27,7,35
43SWE,1988 Winter Olympics,43,SWE,Sweden,59,7,0,24,31
22SWE,1988 Summer Olympics,22,SWE,Sweden,141,0,5,11,16
42SWE,1984 Winter Olympics,42,SWE,Sweden,46,7,2,21,30
21SWE,1984 Summer Olympics,21,SWE,Sweden,135,3,18,14,35
41SWE,1980 Winter Olympics,41,SWE,Sweden,42,3,0,20,23
20SWE,1980 Summer Olympics,20,SWE,Sweden,116,3,8,9,20
40SWE,1976 Winter Olympics,40,SWE,Sweden,28,0,0,2,2
19SWE,1976 Summer Olympics,19,SWE,Sweden,73,9,1,0,10
39SWE,1972 Winter Olympics,39,SWE,Sweden,39,1,1,2,4
18SWE,1972 Summer Olympics,18,SWE,Sweden,100,4,10,8,22
38SWE,1968 Winter Olympics,38,SWE,Sweden,47,3,7,6,16
17SWE,1968 Summer Olympics,17,SWE,Sweden,73,4,4,1,9
37SWE,1964 Winter Olympics,37,SWE,Sweden,33,6,21,1,28
16SWE,1964 Summer Olympics,16,SWE,Sweden,64,3,4,8,15
36SWE,1960 Winter Olympics,36,SWE,Sweden,33,5,2,2,9
15SWE,1960 Summer Olympics,15,SWE,Sweden,101,2,2,3,7
48SWE,1956 Equestrian Olympics,48,SWE,Sweden,5,5,0,0,5
35SWE,1956 Winter Olympics,35,SWE,Sweden,37,2,4,9,15
14SWE,1956 Summer Olympics,14,SWE,Sweden,43,9,14,6,29
34SWE,1952 Winter Olympics,34,SWE,Sweden,62,0,0,23,23
13SWE,1952 Summer Olympics,13,SWE,Sweden,170,23,24,31,78
33SWE,1948 Winter Olympics,33,SWE,Sweden,46,7,3,3,13
12SWE,1948 Summer Olympics,12,SWE,Sweden,177,36,15,32,83
32SWE,1936 Winter Olympics,32,SWE,Sweden,32,2,2,6,10
11SWE,1936 Summer Olympics,11,SWE,Sweden,160,7,11,17,35
31SWE,1932 Winter Olympics,31,SWE,Sweden,10,1,2,0,3
10SWE,1932 Summer Olympics,10,SWE,Sweden,62,13,7,13,33
30SWE,1928 Winter Olympics,30,SWE,Sweden,17,2,13,1,16
9SWE,1928 Summer Olympics,9,SWE,Sweden,73,7,8,22,37
29SWE,1924 Winter Olympics,29,SWE,Sweden,34,1,8,0,9
8SWE,1924 Summer Olympics,8,SWE,Sweden,103,7,24,47,78
7SWE,1920 Summer Olympics,7,SWE,Sweden,208,53,38,64,155
6SWE,1912 Summer Olympics,6,SWE,Sweden,422,102,63,25,190
5SWE,1908 Summer Olympics,5,SWE,Sweden,181,48,18,18,84
2SWE,1900 Summer Olympics,2,SWE,Sweden,7,6,0,1,7
1SWE,1896 Summer Olympics,1,SWE,Sweden,3,0,0,0,0
62SUI,2022 Winter Olympics,62,SUI,Switzerland,78,7,2,6,15
61SUI,2020 Summer Olympics,61,SUI,Switzerland,71,3,5,7,15
60SUI,2018 Winter Olympics,60,SUI,Switzerland,88,9,7,8,24
59SUI,2016 Summer Olympics,59,SUI,Switzerland,68,6,3,2,11
58SUI,2014 Winter Olympics,58,SUI,Switzerland,94,8,2,22,32
54SUI,2012 Summer Olympics,54,SUI,Switzerland,70,2,2,0,4
57SUI,2010 Winter Olympics,57,SUI,Switzerland,82,6,0,7,13
53SUI,2008 Summer Olympics,53,SUI,Switzerland,48,3,1,7,11
49SUI,2006 Winter Olympics,49,SUI,Switzerland,76,5,8,9,22
26SUI,2004 Summer Olympics,26,SUI,Switzerland,55,1,2,4,7
47SUI,2002 Winter Olympics,47,SUI,Switzerland,78,3,7,14,24
25SUI,2000 Summer Olympics,25,SUI,Switzerland,73,1,11,2,14
46SUI,1998 Winter Olympics,46,SUI,Switzerland,45,6,5,3,14
24SUI,1996 Summer Olympics,24,SUI,Switzerland,92,5,6,0,11
45SUI,1994 Winter Olympics,45,SUI,Switzerland,21,4,8,4,16
44SUI,1992 Winter Olympics,44,SUI,Switzerland,66,2,0,5,7
23SUI,1992 Summer Olympics,23,SUI,Switzerland,83,1,0,0,1
43SUI,1988 Winter Olympics,43,SUI,Switzerland,69,8,7,5,20
22SUI,1988 Summer Olympics,22,SUI,Switzerland,64,0,6,2,8
42SUI,1984 Winter Olympics,42,SUI,Switzerland,38,2,2,4,8
21SUI,1984 Summer Olympics,21,SUI,Switzerland,109,0,9,4,13
41SUI,1980 Winter Olympics,41,SUI,Switzerland,29,2,4,3,9
20SUI,1980 Summer Olympics,20,SUI,Switzerland,64,2,0,0,2
40SUI,1976 Winter Olympics,40,SUI,Switzerland,42,1,6,2,9
19SUI,1976 Summer Olympics,19,SUI,Switzerland,37,1,3,6,10
39SUI,1972 Winter Olympics,39,SUI,Switzerland,43,7,3,7,17
18SUI,1972 Summer Olympics,18,SUI,Switzerland,127,0,8,0,8
38SUI,1968 Winter Olympics,38,SUI,Switzerland,22,0,2,7,9
17SUI,1968 Summer Olympics,17,SUI,Switzerland,63,0,3,10,13
37SUI,1964 Winter Olympics,37,SUI,Switzerland,85,0,0,0,0
16SUI,1964 Summer Olympics,16,SUI,Switzerland,43,1,4,1,6
36SUI,1960 Winter Olympics,36,SUI,Switzerland,14,2,0,0,2
15SUI,1960 Summer Olympics,15,SUI,Switzerland,129,0,6,6,12
48SUI,1956 Equestrian Olympics,48,SUI,Switzerland,5,0,0,3,3
35SUI,1956 Winter Olympics,35,SUI,Switzerland,46,6,2,2,10
34SUI,1952 Winter Olympics,34,SUI,Switzerland,36,0,0,6,6
13SUI,1952 Summer Olympics,13,SUI,Switzerland,123,2,19,12,33
33SUI,1948 Winter Olympics,33,SUI,Switzerland,73,4,5,19,28
12SUI,1948 Summer Olympics,12,SUI,Switzerland,166,5,24,6,35
32SUI,1936 Winter Olympics,32,SUI,Switzerland,39,4,6,0,10
11SUI,1936 Summer Olympics,11,SUI,Switzerland,211,5,23,25,53
31SUI,1932 Winter Olympics,31,SUI,Switzerland,14,0,2,0,2
10SUI,1932 Summer Olympics,10,SUI,Switzerland,3,0,1,0,1
30SUI,1928 Winter Olympics,30,SUI,Switzerland,45,0,0,12,12
9SUI,1928 Summer Olympics,9,SUI,Switzerland,124,18,13,4,35
29SUI,1924 Winter Olympics,29,SUI,Switzerland,34,8,0,1,9
8SUI,1924 Summer Olympics,8,SUI,Switzerland,135,15,32,21,68
7SUI,1920 Summer Olympics,7,SUI,Switzerland,82,6,2,21,29
6SUI,1912 Summer Olympics,6,SUI,Switzerland,6,1,0,0,1
5SUI,1908 Summer Olympics,5,SUI,Switzerland,4,0,0,0,0
2SUI,1900 Summer Olympics,2,SUI,Switzerland,26,16,5,1,22
1SUI,1896 Summer Olympics,1,SUI,Switzerland,2,1,2,0,3
62ESP,2022 Winter Olympics,62,ESP,Spain,8,0,1,0,1
61ESP,2020 Summer Olympics,61,ESP,Spain,195,4,44,22,70
60ESP,2018 Winter Olympics,60,ESP,Spain,5,0,0,2,2
59ESP,2016 Summer Olympics,59,ESP,Spain,180,9,19,17,45
58ESP,2014 Winter Olympics,58,ESP,Spain,10,0,0,0,0
54ESP,2012 Summer Olympics,54,ESP,Spain,172,6,34,28,68
57ESP,2010 Winter Olympics,57,ESP,Spain,11,0,0,0,0
53ESP,2008 Summer Olympics,53,ESP,Spain,152,7,51,16,74
49ESP,2006 Winter Olympics,49,ESP,Spain,11,0,0,0,0
26ESP,2004 Summer Olympics,26,ESP,Spain,185,4,17,9,30
47ESP,2002 Winter Olympics,47,ESP,Spain,1,0,0,0,0
25ESP,2000 Summer Olympics,25,ESP,Spain,201,3,24,20,47
46ESP,1998 Winter Olympics,46,ESP,Spain,6,0,0,0,0
24ESP,1996 Summer Olympics,24,ESP,Spain,171,24,21,22,67
45ESP,1994 Winter Olympics,45,ESP,Spain,5,0,0,0,0
44ESP,1992 Winter Olympics,44,ESP,Spain,12,0,0,1,1
23ESP,1992 Summer Olympics,23,ESP,Spain,376,52,20,2,74
43ESP,1988 Winter Olympics,43,ESP,Spain,9,0,0,0,0
22ESP,1988 Summer Olympics,22,ESP,Spain,177,1,2,2,5
42ESP,1984 Winter Olympics,42,ESP,Spain,11,0,0,0,0
21ESP,1984 Summer Olympics,21,ESP,Spain,112,2,14,3,19
41ESP,1980 Winter Olympics,41,ESP,Spain,7,0,0,0,0
20ESP,1980 Summer Olympics,20,ESP,Spain,125,2,19,3,24
40ESP,1976 Winter Olympics,40,ESP,Spain,3,0,0,0,0
19ESP,1976 Summer Olympics,19,ESP,Spain,79,0,6,0,6
39ESP,1972 Winter Olympics,39,ESP,Spain,1,1,0,0,1
18ESP,1972 Summer Olympics,18,ESP,Spain,95,0,0,1,1
38ESP,1968 Winter Olympics,38,ESP,Spain,18,0,0,0,0
17ESP,1968 Summer Olympics,17,ESP,Spain,115,0,0,0,0
37ESP,1964 Winter Olympics,37,ESP,Spain,5,0,0,0,0
16ESP,1964 Summer Olympics,16,ESP,Spain,38,0,0,0,0
36ESP,1960 Winter Olympics,36,ESP,Spain,4,0,0,0,0
15ESP,1960 Summer Olympics,15,ESP,Spain,140,0,0,18,18
48ESP,1956 Equestrian Olympics,48,ESP,Spain,5,0,0,0,0
35ESP,1956 Winter Olympics,35,ESP,Spain,6,0,0,0,0
34ESP,1952 Winter Olympics,34,ESP,Spain,3,0,0,0,0
13ESP,1952 Summer Olympics,13,ESP,Spain,27,0,1,0,1
33ESP,1948 Winter Olympics,33,ESP,Spain,6,0,0,0,0
12ESP,1948 Summer Olympics,12,ESP,Spain,80,0,3,0,3
32ESP,1936 Winter Olympics,32,ESP,Spain,6,0,0,0,0
10ESP,1932 Summer Olympics,10,ESP,Spain,5,0,0,1,1
9ESP,1928 Summer Olympics,9,ESP,Spain,74,3,0,0,3
8ESP,1924 Summer Olympics,8,ESP,Spain,126,0,0,0,0
7ESP,1920 Summer Olympics,7,ESP,Spain,65,0,27,0,27
2ESP,1900 Summer Olympics,2,ESP,Spain,16,2,0,0,2
44YUG,1992 Winter Olympics,44,YUG,Yugoslavia,14,0,0,0,0
43YUG,1988 Winter Olympics,43,YUG,Yugoslavia,8,0,5,1,6
22YUG,1988 Summer Olympics,22,YUG,Yugoslavia,72,15,27,21,63
42YUG,1984 Winter Olympics,42,YUG,Yugoslavia,55,0,1,0,1
21YUG,1984 Summer Olympics,21,YUG,Yugoslavia,84,48,5,35,88
41YUG,1980 Winter Olympics,41,YUG,Yugoslavia,13,0,0,0,0
20YUG,1980 Summer Olympics,20,YUG,Yugoslavia,127,13,27,17,57
40YUG,1976 Winter Olympics,40,YUG,Yugoslavia,19,0,0,0,0
19YUG,1976 Summer Olympics,19,YUG,Yugoslavia,58,2,14,3,19
39YUG,1972 Winter Olympics,39,YUG,Yugoslavia,12,0,0,0,0
18YUG,1972 Summer Olympics,18,YUG,Yugoslavia,98,17,1,2,20
38YUG,1968 Winter Olympics,38,YUG,Yugoslavia,16,0,0,0,0
17YUG,1968 Summer Olympics,17,YUG,Yugoslavia,50,13,14,2,29
37YUG,1964 Winter Olympics,37,YUG,Yugoslavia,30,0,0,0,0
16YUG,1964 Summer Olympics,16,YUG,Yugoslavia,49,2,11,2,15
15YUG,1960 Summer Olympics,15,YUG,Yugoslavia,105,18,1,0,19
35YUG,1956 Winter Olympics,35,YUG,Yugoslavia,14,0,0,0,0
14YUG,1956 Summer Olympics,14,YUG,Yugoslavia,28,0,29,0,29
34YUG,1952 Winter Olympics,34,YUG,Yugoslavia,3,0,0,0,0
13YUG,1952 Summer Olympics,13,YUG,Yugoslavia,84,4,31,0,35
33YUG,1948 Winter Olympics,33,YUG,Yugoslavia,12,0,0,0,0
12YUG,1948 Summer Olympics,12,YUG,Yugoslavia,94,0,23,0,23
32YUG,1936 Winter Olympics,32,YUG,Yugoslavia,19,0,0,0,0
11YUG,1936 Summer Olympics,11,YUG,Yugoslavia,109,0,1,0,1
10YUG,1932 Summer Olympics,10,YUG,Yugoslavia,0,0,0,0,0
30YUG,1928 Winter Olympics,30,YUG,Yugoslavia,6,0,0,0,0
9YUG,1928 Summer Olympics,9,YUG,Yugoslavia,41,1,1,10,12
29YUG,1924 Winter Olympics,29,YUG,Yugoslavia,6,0,0,0,0
8YUG,1924 Summer Olympics,8,YUG,Yugoslavia,52,2,0,0,2
7YUG,1920 Summer Olympics,7,YUG,Yugoslavia,18,0,0,0,0
43FRG,1988 Winter Olympics,43,FRG,West Germany,40,4,7,3,14
22FRG,1988 Summer Olympics,22,FRG,West Germany,186,32,37,48,117
42FRG,1984 Winter Olympics,42,FRG,West Germany,58,3,1,4,8
21FRG,1984 Summer Olympics,21,FRG,West Germany,325,30,77,56,163
41FRG,1980 Winter Olympics,41,FRG,West Germany,51,0,2,6,8
40FRG,1976 Winter Olympics,40,FRG,West Germany,39,2,7,23,32
19FRG,1976 Summer Olympics,19,FRG,West Germany,193,21,27,35,83
39FRG,1972 Winter Olympics,39,FRG,West Germany,46,4,2,4,10
18FRG,1972 Summer Olympics,18,FRG,West Germany,323,46,19,45,110
38FRG,1968 Winter Olympics,38,FRG,West Germany,73,2,3,5,10
17FRG,1968 Summer Olympics,17,FRG,West Germany,201,17,16,20,53
43URS,1988 Winter Olympics,43,URS,Soviet Union,39,41,14,12,67
22URS,1988 Summer Olympics,22,URS,Soviet Union,240,140,67,100,307
42URS,1984 Winter Olympics,42,URS,Soviet Union,62,29,15,12,56
41URS,1980 Winter Olympics,41,URS,Soviet Union,55,18,29,7,54
20URS,1980 Summer Olympics,20,URS,Soviet Union,341,193,131,126,450
40URS,1976 Winter Olympics,40,URS,Soviet Union,51,38,7,11,56
19URS,1976 Summer Olympics,19,URS,Soviet Union,303,114,95,85,294
39URS,1972 Winter Olympics,39,URS,Soviet Union,50,36,6,3,45
18URS,1972 Summer Olympics,18,URS,Soviet Union,263,107,49,60,216
38URS,1968 Winter Olympics,38,URS,Soviet Union,52,26,6,5,37
17URS,1968 Summer Olympics,17,URS,Soviet Union,218,66,63,66,195
37URS,1964 Winter Olympics,37,URS,Soviet Union,40,30,8,9,47
16URS,1964 Summer Olympics,16,URS,Soviet Union,217,61,63,51,175
36URS,1960 Winter Olympics,36,URS,Soviet Union,43,7,7,28,42
15URS,1960 Summer Olympics,15,URS,Soviet Union,197,61,65,45,171
48URS,1956 Equestrian Olympics,48,URS,Soviet Union,4,0,0,0,0
35URS,1956 Winter Olympics,35,URS,Soviet Union,53,26,5,6,37
14URS,1956 Summer Olympics,14,URS,Soviet Union,211,70,48,59,177
13URS,1952 Summer Olympics,13,URS,Soviet Union,317,36,65,19,120
62UKR,2022 Winter Olympics,62,UKR,Ukraine,23,0,1,0,1
61UKR,2020 Summer Olympics,61,UKR,Ukraine,87,1,7,21,29
60UKR,2018 Winter Olympics,60,UKR,Ukraine,14,1,0,0,1
59UKR,2016 Summer Olympics,59,UKR,Ukraine,119,2,8,5,15
58UKR,2014 Winter Olympics,58,UKR,Ukraine,24,4,0,1,5
54UKR,2012 Summer Olympics,54,UKR,Ukraine,122,8,4,16,28
57UKR,2010 Winter Olympics,57,UKR,Ukraine,20,0,0,0,0
53UKR,2008 Summer Olympics,53,UKR,Ukraine,151,10,4,12,26
49UKR,2006 Winter Olympics,49,UKR,Ukraine,26,0,0,3,3
26UKR,2004 Summer Olympics,26,UKR,Ukraine,152,8,8,31,47
47UKR,2002 Winter Olympics,47,UKR,Ukraine,45,0,0,0,0
25UKR,2000 Summer Olympics,25,UKR,Ukraine,147,3,20,12,35
46UKR,1998 Winter Olympics,46,UKR,Ukraine,42,0,1,0,1
24UKR,1996 Summer Olympics,24,UKR,Ukraine,194,10,5,19,34
45UKR,1994 Winter Olympics,45,UKR,Ukraine,30,1,0,1,2
61VEN,2020 Summer Olympics,61,VEN,Venezuela,31,1,3,0,4
59VEN,2016 Summer Olympics,59,VEN,Venezuela,54,0,2,1,3
58VEN,2014 Winter Olympics,58,VEN,Venezuela,1,0,0,0,0
54VEN,2012 Summer Olympics,54,VEN,Venezuela,45,1,0,0,1
53VEN,2008 Summer Olympics,53,VEN,Venezuela,89,0,0,1,1
49VEN,2006 Winter Olympics,49,VEN,Venezuela,0,0,0,0,0
26VEN,2004 Summer Olympics,26,VEN,Venezuela,34,0,0,2,2
47VEN,2002 Winter Olympics,47,VEN,Venezuela,3,0,0,0,0
25VEN,2000 Summer Olympics,25,VEN,Venezuela,36,0,0,0,0
46VEN,1998 Winter Olympics,46,VEN,Venezuela,1,0,0,0,0
24VEN,1996 Summer Olympics,24,VEN,Venezuela,33,0,0,0,0
23VEN,1992 Summer Olympics,23,VEN,Venezuela,32,0,0,0,0
22VEN,1988 Summer Olympics,22,VEN,Venezuela,14,0,0,0,0
21VEN,1984 Summer Olympics,21,VEN,Venezuela,20,0,0,3,3
20VEN,1980 Summer Olympics,20,VEN,Venezuela,37,0,1,0,1
19VEN,1976 Summer Olympics,19,VEN,Venezuela,29,0,1,0,1
18VEN,1972 Summer Olympics,18,VEN,Venezuela,21,0,0,0,0
17VEN,1968 Summer Olympics,17,VEN,Venezuela,16,1,0,0,1
16VEN,1964 Summer Olympics,16,VEN,Venezuela,9,0,0,0,0
15VEN,1960 Summer Olympics,15,VEN,Venezuela,30,0,0,1,1
48VEN,1956 Equestrian Olympics,48,VEN,Venezuela,3,0,0,0,0
14VEN,1956 Summer Olympics,14,VEN,Venezuela,17,0,0,0,0
13VEN,1952 Summer Olympics,13,VEN,Venezuela,39,0,0,1,1
12VEN,1948 Summer Olympics,12,VEN,Venezuela,1,0,0,0,0
10VEN,1932 Summer Olympics,10,VEN,Venezuela,1,0,0,0,0
62TUR,2022 Winter Olympics,62,TUR,Türkiye,4,0,0,0,0
61TUR,2020 Summer Olympics,61,TUR,Türkiye,70,2,2,9,13
60TUR,2018 Winter Olympics,60,TUR,Türkiye,6,0,0,0,0
59TUR,2016 Summer Olympics,59,TUR,Türkiye,62,1,3,4,8
58TUR,2014 Winter Olympics,58,TUR,Türkiye,3,0,0,0,0
54TUR,2012 Summer Olympics,54,TUR,Türkiye,85,1,1,1,3
57TUR,2010 Winter Olympics,57,TUR,Türkiye,2,0,0,0,0
53TUR,2008 Summer Olympics,53,TUR,Türkiye,44,1,1,3,5
49TUR,2006 Winter Olympics,49,TUR,Türkiye,4,0,0,0,0
26TUR,2004 Summer Olympics,26,TUR,Türkiye,42,3,3,4,10
47TUR,2002 Winter Olympics,47,TUR,Türkiye,3,0,0,0,0
25TUR,2000 Summer Olympics,25,TUR,Türkiye,39,3,0,2,5
46TUR,1998 Winter Olympics,46,TUR,Türkiye,1,0,0,0,0
24TUR,1996 Summer Olympics,24,TUR,Türkiye,35,4,1,1,6
45TUR,1994 Winter Olympics,45,TUR,Türkiye,0,0,0,0,0
44TUR,1992 Winter Olympics,44,TUR,Türkiye,4,0,0,0,0
23TUR,1992 Summer Olympics,23,TUR,Türkiye,36,2,2,2,6
43TUR,1988 Winter Olympics,43,TUR,Türkiye,6,0,0,0,0
22TUR,1988 Summer Olympics,22,TUR,Türkiye,37,1,1,0,2
42TUR,1984 Winter Olympics,42,TUR,Türkiye,7,0,0,0,0
21TUR,1984 Summer Olympics,21,TUR,Türkiye,42,0,0,3,3
40TUR,1976 Winter Olympics,40,TUR,Türkiye,7,0,0,0,0
19TUR,1976 Summer Olympics,19,TUR,Türkiye,21,0,0,0,0
18TUR,1972 Summer Olympics,18,TUR,Türkiye,37,0,1,0,1
38TUR,1968 Winter Olympics,38,TUR,Türkiye,10,0,0,0,0
17TUR,1968 Summer Olympics,17,TUR,Türkiye,23,2,0,0,2
37TUR,1964 Winter Olympics,37,TUR,Türkiye,2,0,0,0,0
16TUR,1964 Summer Olympics,16,TUR,Türkiye,12,2,3,1,6
36TUR,1960 Winter Olympics,36,TUR,Türkiye,0,0,0,0,0
15TUR,1960 Summer Olympics,15,TUR,Türkiye,39,7,2,0,9
48TUR,1956 Equestrian Olympics,48,TUR,Türkiye,5,0,0,0,0
35TUR,1956 Winter Olympics,35,TUR,Türkiye,2,0,0,0,0
14TUR,1956 Summer Olympics,14,TUR,Türkiye,10,3,2,2,7
13TUR,1952 Summer Olympics,13,TUR,Türkiye,53,2,0,1,3
33TUR,1948 Winter Olympics,33,TUR,Türkiye,5,0,0,0,0
12TUR,1948 Summer Olympics,12,TUR,Türkiye,64,6,4,2,12
32TUR,1936 Winter Olympics,32,TUR,Türkiye,6,0,0,0,0
11TUR,1936 Summer Olympics,11,TUR,Türkiye,54,1,0,1,2
10TUR,1932 Summer Olympics,10,TUR,Türkiye,1,0,0,0,0
9TUR,1928 Summer Olympics,9,TUR,Türkiye,27,0,0,0,0
8TUR,1924 Summer Olympics,8,TUR,Türkiye,39,0,0,0,0
6TUR,1912 Summer Olympics,6,TUR,Türkiye,2,0,0,0,0
5TUR,1908 Summer Olympics,5,TUR,Türkiye,1,0,0,0,0
62FRA,2022 Winter Olympics,62,FRA,France,32,6,13,5,24
61FRA,2020 Summer Olympics,61,FRA,France,257,65,42,31,138
60FRA,2018 Winter Olympics,60,FRA,France,41,8,5,13,26
59FRA,2016 Summer Olympics,59,FRA,France,265,20,55,21,96
58FRA,2014 Winter Olympics,58,FRA,France,58,4,4,10,18
54FRA,2012 Summer Olympics,54,FRA,France,209,30,30,22,82
57FRA,2010 Winter Olympics,57,FRA,France,61,2,6,6,14
53FRA,2008 Summer Olympics,53,FRA,France,193,25,24,30,79
49FRA,2006 Winter Olympics,49,FRA,France,44,3,2,10,15
26FRA,2004 Summer Olympics,26,FRA,France,199,21,10,24,55
47FRA,2002 Winter Olympics,47,FRA,France,67,5,5,5,15
25FRA,2000 Summer Olympics,25,FRA,France,214,22,30,14,66
46FRA,1998 Winter Olympics,46,FRA,France,62,2,1,12,15
24FRA,1996 Summer Olympics,24,FRA,France,204,21,10,20,51
45FRA,1994 Winter Olympics,45,FRA,France,34,0,1,10,11
44FRA,1992 Winter Olympics,44,FRA,France,93,5,6,1,12
23FRA,1992 Summer Olympics,23,FRA,France,254,9,5,43,57
43FRA,1988 Winter Olympics,43,FRA,France,76,1,0,1,2
22FRA,1988 Summer Olympics,22,FRA,France,203,12,4,15,31
42FRA,1984 Winter Olympics,42,FRA,France,21,0,1,2,3
21FRA,1984 Summer Olympics,21,FRA,France,197,21,16,31,68
41FRA,1980 Winter Olympics,41,FRA,France,15,0,0,1,1
20FRA,1980 Summer Olympics,20,FRA,France,85,18,5,8,31
40FRA,1976 Winter Olympics,40,FRA,France,23,0,0,1,1
19FRA,1976 Summer Olympics,19,FRA,France,144,5,7,8,20
39FRA,1972 Winter Olympics,39,FRA,France,25,0,1,2,3
18FRA,1972 Summer Olympics,18,FRA,France,178,2,5,17,24
38FRA,1968 Winter Olympics,38,FRA,France,70,4,3,2,9
17FRA,1968 Summer Olympics,17,FRA,France,172,12,5,12,29
37FRA,1964 Winter Olympics,37,FRA,France,16,3,4,0,7
16FRA,1964 Summer Olympics,16,FRA,France,91,1,13,19,33
36FRA,1960 Winter Olympics,36,FRA,France,14,1,0,2,3
15FRA,1960 Summer Olympics,15,FRA,France,181,0,6,6,12
48FRA,1956 Equestrian Olympics,48,FRA,France,5,0,0,0,0
35FRA,1956 Winter Olympics,35,FRA,France,26,0,0,0,0
14FRA,1956 Summer Olympics,14,FRA,France,89,7,13,14,34
34FRA,1952 Winter Olympics,34,FRA,France,19,0,0,1,1
13FRA,1952 Summer Olympics,13,FRA,France,175,14,9,19,42
33FRA,1948 Winter Olympics,33,FRA,France,38,2,1,2,5
12FRA,1948 Summer Olympics,12,FRA,France,318,26,26,27,79
32FRA,1936 Winter Olympics,32,FRA,France,28,0,0,1,1
11FRA,1936 Summer Olympics,11,FRA,France,188,13,13,23,49
31FRA,1932 Winter Olympics,31,FRA,France,7,2,0,0,2
10FRA,1932 Summer Olympics,10,FRA,France,75,24,8,6,38
30FRA,1928 Winter Olympics,30,FRA,France,25,2,0,0,2
9FRA,1928 Summer Olympics,9,FRA,France,265,12,25,14,51
29FRA,1924 Winter Olympics,29,FRA,France,43,0,0,12,12
8FRA,1924 Summer Olympics,8,FRA,France,409,42,61,22,125
7FRA,1920 Summer Olympics,7,FRA,France,291,13,79,57,149
6FRA,1912 Summer Olympics,6,FRA,France,191,10,11,5,26
5FRA,1908 Summer Olympics,5,FRA,France,259,12,5,23,40
2FRA,1900 Summer Olympics,2,FRA,France,1417,57,113,88,258
1FRA,1896 Summer Olympics,1,FRA,France,18,5,4,2,11
62POL,2022 Winter Olympics,62,POL,Poland,28,0,0,1,1
61POL,2020 Summer Olympics,61,POL,Poland,119,14,14,8,36
60POL,2018 Winter Olympics,60,POL,Poland,32,1,0,4,5
59POL,2016 Summer Olympics,59,POL,Poland,134,3,3,10,16
58POL,2014 Winter Olympics,58,POL,Poland,31,4,4,4,12
54POL,2012 Summer Olympics,54,POL,Poland,110,3,2,8,13
57POL,2010 Winter Olympics,57,POL,Poland,28,1,3,5,9
53POL,2008 Summer Olympics,53,POL,Poland,159,7,12,2,21
49POL,2006 Winter Olympics,49,POL,Poland,34,0,1,1,2
26POL,2004 Summer Olympics,26,POL,Poland,129,4,2,6,12
47POL,2002 Winter Olympics,47,POL,Poland,5,0,1,1,2
25POL,2000 Summer Olympics,25,POL,Poland,126,7,10,7,24
46POL,1998 Winter Olympics,46,POL,Poland,25,0,0,0,0
24POL,1996 Summer Olympics,24,POL,Poland,96,7,8,7,22
45POL,1994 Winter Olympics,45,POL,Poland,12,0,0,0,0
44POL,1992 Winter Olympics,44,POL,Poland,47,0,0,0,0
23POL,1992 Summer Olympics,23,POL,Poland,158,5,26,19,50
43POL,1988 Winter Olympics,43,POL,Poland,19,0,0,0,0
22POL,1988 Summer Olympics,22,POL,Poland,127,2,9,10,21
42POL,1984 Winter Olympics,42,POL,Poland,19,0,0,0,0
41POL,1980 Winter Olympics,41,POL,Poland,17,0,0,0,0
20POL,1980 Summer Olympics,20,POL,Poland,235,3,27,22,52
40POL,1976 Winter Olympics,40,POL,Poland,39,0,0,0,0
19POL,1976 Summer Olympics,19,POL,Poland,130,18,31,26,75
39POL,1972 Winter Olympics,39,POL,Poland,38,1,0,0,1
18POL,1972 Summer Olympics,18,POL,Poland,233,29,8,11,48
38POL,1968 Winter Olympics,38,POL,Poland,19,0,0,0,0
17POL,1968 Summer Olympics,17,POL,Poland,119,5,2,30,37
37POL,1964 Winter Olympics,37,POL,Poland,39,0,0,0,0
16POL,1964 Summer Olympics,16,POL,Poland,80,12,16,26,54
36POL,1960 Winter Olympics,36,POL,Poland,8,0,1,1,2
15POL,1960 Summer Olympics,15,POL,Poland,160,4,11,17,32
35POL,1956 Winter Olympics,35,POL,Poland,38,0,0,1,1
14POL,1956 Summer Olympics,14,POL,Poland,44,1,9,9,19
34POL,1952 Winter Olympics,34,POL,Poland,19,0,0,0,0
13POL,1952 Summer Olympics,13,POL,Poland,145,1,2,1,4
33POL,1948 Winter Olympics,33,POL,Poland,25,0,0,0,0
12POL,1948 Summer Olympics,12,POL,Poland,34,1,0,1,2
32POL,1936 Winter Olympics,32,POL,Poland,15,0,0,0,0
11POL,1936 Summer Olympics,11,POL,Poland,136,0,6,6,12
31POL,1932 Winter Olympics,31,POL,Poland,5,0,0,0,0
10POL,1932 Summer Olympics,10,POL,Poland,39,3,4,14,21
30POL,1928 Winter Olympics,30,POL,Poland,26,0,0,0,0
9POL,1928 Summer Olympics,9,POL,Poland,93,2,3,17,22
29POL,1924 Winter Olympics,29,POL,Poland,10,0,0,0,0
8POL,1924 Summer Olympics,8,POL,Poland,82,0,4,1,5
6POL,1912 Summer Olympics,6,POL,Poland,1,0,0,0,0
61ZIM,2020 Summer Olympics,61,ZIM,Zimbabwe,5,0,0,0,0
59ZIM,2016 Summer Olympics,59,ZIM,Zimbabwe,30,0,0,0,0
58ZIM,2014 Winter Olympics,58,ZIM,Zimbabwe,1,0,0,0,0
54ZIM,2012 Summer Olympics,54,ZIM,Zimbabwe,4,0,0,0,0
53ZIM,2008 Summer Olympics,53,ZIM,Zimbabwe,8,1,3,0,4
26ZIM,2004 Summer Olympics,26,ZIM,Zimbabwe,8,1,1,1,3
25ZIM,2000 Summer Olympics,25,ZIM,Zimbabwe,11,0,0,0,0
24ZIM,1996 Summer Olympics,24,ZIM,Zimbabwe,10,0,0,0,0
23ZIM,1992 Summer Olympics,23,ZIM,Zimbabwe,12,0,0,0,0
22ZIM,1988 Summer Olympics,22,ZIM,Zimbabwe,29,0,0,0,0
21ZIM,1984 Summer Olympics,21,ZIM,Zimbabwe,12,0,0,0,0
20ZIM,1980 Summer Olympics,20,ZIM,Zimbabwe,43,16,0,0,16
16ZIM,1964 Summer Olympics,16,ZIM,Zimbabwe,29,0,0,0,0
15ZIM,1960 Summer Olympics,15,ZIM,Zimbabwe,2,0,0,0,0
9ZIM,1928 Summer Olympics,9,ZIM,Zimbabwe,2,0,0,0,0
61URU,2020 Summer Olympics,61,URU,Uruguay,7,0,0,0,0
59URU,2016 Summer Olympics,59,URU,Uruguay,13,0,0,0,0
54URU,2012 Summer Olympics,54,URU,Uruguay,30,0,0,0,0
53URU,2008 Summer Olympics,53,URU,Uruguay,4,0,0,0,0
26URU,2004 Summer Olympics,26,URU,Uruguay,11,0,0,0,0
25URU,2000 Summer Olympics,25,URU,Uruguay,13,0,1,0,1
46URU,1998 Winter Olympics,46,URU,Uruguay,1,0,0,0,0
24URU,1996 Summer Olympics,24,URU,Uruguay,11,0,0,0,0
23URU,1992 Summer Olympics,23,URU,Uruguay,20,0,0,0,0
22URU,1988 Summer Olympics,22,URU,Uruguay,12,0,0,0,0
21URU,1984 Summer Olympics,21,URU,Uruguay,19,0,0,0,0
19URU,1976 Summer Olympics,19,URU,Uruguay,9,0,0,0,0
18URU,1972 Summer Olympics,18,URU,Uruguay,10,0,0,0,0
17URU,1968 Summer Olympics,17,URU,Uruguay,32,0,0,0,0
16URU,1964 Summer Olympics,16,URU,Uruguay,15,0,0,1,1
15URU,1960 Summer Olympics,15,URU,Uruguay,22,0,0,0,0
14URU,1956 Summer Olympics,14,URU,Uruguay,15,0,0,12,12
13URU,1952 Summer Olympics,13,URU,Uruguay,17,0,0,14,14
12URU,1948 Summer Olympics,12,URU,Uruguay,61,0,1,2,3
11URU,1936 Summer Olympics,11,URU,Uruguay,47,0,0,0,0
10URU,1932 Summer Olympics,10,URU,Uruguay,2,0,0,1,1
9URU,1928 Summer Olympics,9,URU,Uruguay,14,22,0,0,22
8URU,1924 Summer Olympics,8,URU,Uruguay,38,22,0,0,22
62ITA,2022 Winter Olympics,62,ITA,Italy,59,3,13,12,28
61ITA,2020 Summer Olympics,61,ITA,Italy,257,21,17,38,76
60ITA,2018 Winter Olympics,60,ITA,Italy,53,3,6,8,17
59ITA,2016 Summer Olympics,59,ITA,Italy,178,8,40,24,72
58ITA,2014 Winter Olympics,58,ITA,Italy,57,0,2,13,15
54ITA,2012 Summer Olympics,54,ITA,Italy,149,16,22,30,68
57ITA,2010 Winter Olympics,57,ITA,Italy,43,1,1,3,5
53ITA,2008 Summer Olympics,53,ITA,Italy,180,8,14,21,43
49ITA,2006 Winter Olympics,49,ITA,Italy,117,12,0,15,27
26ITA,2004 Summer Olympics,26,ITA,Italy,238,24,41,44,109
47ITA,2002 Winter Olympics,47,ITA,Italy,63,4,11,6,21
25ITA,2000 Summer Olympics,25,ITA,Italy,240,22,14,29,65
46ITA,1998 Winter Olympics,46,ITA,Italy,48,3,9,5,17
24ITA,1996 Summer Olympics,24,ITA,Italy,211,19,24,28,71
45ITA,1994 Winter Olympics,45,ITA,Italy,43,15,6,12,33
44ITA,1992 Winter Olympics,44,ITA,Italy,81,4,9,8,21
23ITA,1992 Summer Olympics,23,ITA,Italy,216,22,10,14,46
43ITA,1988 Winter Olympics,43,ITA,Italy,44,2,1,5,8
22ITA,1988 Summer Olympics,22,ITA,Italy,170,11,10,8,29
42ITA,1984 Winter Olympics,42,ITA,Italy,57,2,0,0,2
21ITA,1984 Summer Olympics,21,ITA,Italy,225,30,6,28,64
41ITA,1980 Winter Olympics,41,ITA,Italy,29,0,3,0,3
20ITA,1980 Summer Olympics,20,ITA,Italy,117,8,21,10,39
40ITA,1976 Winter Olympics,40,ITA,Italy,42,1,2,1,4
19ITA,1976 Summer Olympics,19,ITA,Italy,146,2,25,4,31
39ITA,1972 Winter Olympics,39,ITA,Italy,29,3,5,1,9
18ITA,1972 Summer Olympics,18,ITA,Italy,176,9,3,13,25
38ITA,1968 Winter Olympics,38,ITA,Italy,29,8,0,0,8
17ITA,1968 Summer Olympics,17,ITA,Italy,109,5,12,20,37
37ITA,1964 Winter Olympics,37,ITA,Italy,66,0,2,8,10
16ITA,1964 Summer Olympics,16,ITA,Italy,98,14,28,9,51
36ITA,1960 Winter Olympics,36,ITA,Italy,19,0,0,1,1
15ITA,1960 Summer Olympics,15,ITA,Italy,230,37,19,34,90
48ITA,1956 Equestrian Olympics,48,ITA,Italy,3,0,4,1,5
35ITA,1956 Winter Olympics,35,ITA,Italy,53,2,6,0,8
14ITA,1956 Summer Olympics,14,ITA,Italy,92,26,7,9,42
34ITA,1952 Winter Olympics,34,ITA,Italy,17,1,0,1,2
13ITA,1952 Summer Olympics,13,ITA,Italy,192,17,22,15,54
33ITA,1948 Winter Olympics,33,ITA,Italy,52,1,0,0,1
12ITA,1948 Summer Olympics,12,ITA,Italy,206,23,33,16,72
32ITA,1936 Winter Olympics,32,ITA,Italy,42,0,0,0,0
11ITA,1936 Summer Olympics,11,ITA,Italy,230,45,38,5,88
31ITA,1932 Winter Olympics,31,ITA,Italy,12,0,0,0,0
10ITA,1932 Summer Olympics,10,ITA,Italy,79,22,39,21,82
30ITA,1928 Winter Olympics,30,ITA,Italy,16,0,0,0,0
9ITA,1928 Summer Olympics,9,ITA,Italy,150,24,22,31,77
29ITA,1924 Winter Olympics,29,ITA,Italy,26,0,0,0,0
8ITA,1924 Summer Olympics,8,ITA,Italy,193,25,5,22,52
7ITA,1920 Summer Olympics,7,ITA,Italy,155,67,10,8,85
6ITA,1912 Summer Olympics,6,ITA,Italy,87,22,1,2,25
5ITA,1908 Summer Olympics,5,ITA,Italy,79,2,6,0,8
3ITA,1904 Summer Olympics,3,ITA,Italy,1,0,0,0,0
2ITA,1900 Summer Olympics,2,ITA,Italy,39,3,2,0,5
1ITA,1896 Summer Olympics,1,ITA,Italy,5,0,0,0,0
62GBR,2022 Winter Olympics,62,GBR,Great Britain,31,5,5,0,10
61GBR,2020 Summer Olympics,61,GBR,Great Britain,267,40,35,57,132
60GBR,2018 Winter Olympics,60,GBR,Great Britain,30,1,0,4,5
59GBR,2016 Summer Olympics,59,GBR,Great Britain,201,67,55,26,148
58GBR,2014 Winter Olympics,58,GBR,Great Britain,34,1,5,10,16
54GBR,2012 Summer Olympics,54,GBR,Great Britain,384,48,31,49,128
57GBR,2010 Winter Olympics,57,GBR,Great Britain,33,1,0,0,1
53GBR,2008 Summer Olympics,53,GBR,Great Britain,203,31,25,35,91
49GBR,2006 Winter Olympics,49,GBR,Great Britain,23,0,1,0,1
26GBR,2004 Summer Olympics,26,GBR,Great Britain,156,19,25,15,59
47GBR,2002 Winter Olympics,47,GBR,Great Britain,33,5,0,1,6
25GBR,2000 Summer Olympics,25,GBR,Great Britain,192,22,20,12,54
46GBR,1998 Winter Olympics,46,GBR,Great Britain,23,0,0,4,4
24GBR,1996 Summer Olympics,24,GBR,Great Britain,165,2,15,9,26
45GBR,1994 Winter Olympics,45,GBR,Great Britain,9,0,0,3,3
44GBR,1992 Winter Olympics,44,GBR,Great Britain,53,0,0,0,0
23GBR,1992 Summer Olympics,23,GBR,Great Britain,238,8,3,39,50
43GBR,1988 Winter Olympics,43,GBR,Great Britain,48,0,0,0,0
22GBR,1988 Summer Olympics,22,GBR,Great Britain,246,22,18,15,55
42GBR,1984 Winter Olympics,42,GBR,Great Britain,37,2,0,0,2
21GBR,1984 Summer Olympics,21,GBR,Great Britain,254,9,22,45,76
41GBR,1980 Winter Olympics,41,GBR,Great Britain,32,1,0,0,1
20GBR,1980 Summer Olympics,20,GBR,Great Britain,158,5,18,30,53
40GBR,1976 Winter Olympics,40,GBR,Great Britain,28,1,0,0,1
19GBR,1976 Summer Olympics,19,GBR,Great Britain,175,6,15,11,32
39GBR,1972 Winter Olympics,39,GBR,Great Britain,29,0,0,0,0
18GBR,1972 Summer Olympics,18,GBR,Great Britain,216,8,11,12,31
38GBR,1968 Winter Olympics,38,GBR,Great Britain,34,0,0,0,0
17GBR,1968 Summer Olympics,17,GBR,Great Britain,175,9,5,5,19
37GBR,1964 Winter Olympics,37,GBR,Great Britain,31,2,0,0,2
16GBR,1964 Summer Olympics,16,GBR,Great Britain,149,4,21,7,32
36GBR,1960 Winter Olympics,36,GBR,Great Britain,12,0,0,0,0
15GBR,1960 Summer Olympics,15,GBR,Great Britain,206,2,11,17,30
48GBR,1956 Equestrian Olympics,48,GBR,Great Britain,5,3,0,4,7
35GBR,1956 Winter Olympics,35,GBR,Great Britain,37,0,0,0,0
14GBR,1956 Summer Olympics,14,GBR,Great Britain,132,5,20,22,47
34GBR,1952 Winter Olympics,34,GBR,Great Britain,13,1,0,0,1
13GBR,1952 Summer Olympics,13,GBR,Great Britain,216,3,2,33,38
33GBR,1948 Winter Olympics,33,GBR,Great Britain,53,0,0,2,2
12GBR,1948 Summer Olympics,12,GBR,Great Britain,417,7,53,12,72
32GBR,1936 Winter Olympics,32,GBR,Great Britain,36,13,1,4,18
11GBR,1936 Summer Olympics,11,GBR,Great Britain,192,16,22,8,46
31GBR,1932 Winter Olympics,31,GBR,Great Britain,4,0,0,0,0
10GBR,1932 Summer Olympics,10,GBR,Great Britain,79,11,16,15,42
30GBR,1928 Winter Olympics,30,GBR,Great Britain,24,0,0,1,1
9GBR,1928 Summer Olympics,9,GBR,Great Britain,202,8,27,28,63
29GBR,1924 Winter Olympics,29,GBR,Great Britain,41,30,4,13,47
8GBR,1924 Summer Olympics,8,GBR,Great Britain,237,15,35,23,73
7GBR,1920 Summer Olympics,7,GBR,Great Britain,186,54,41,17,112
6GBR,1912 Summer Olympics,6,GBR,Great Britain,229,67,66,66,199
5GBR,1908 Summer Olympics,5,GBR,Great Britain,789,180,135,96,411
3GBR,1904 Summer Olympics,3,GBR,Great Britain,5,1,1,0,2
2GBR,1900 Summer Olympics,2,GBR,Great Britain,182,73,27,12,112
1GBR,1896 Summer Olympics,1,GBR,Great Britain,11,4,3,4,11
61ZAM,2020 Summer Olympics,61,ZAM,Zambia,30,0,0,0,0
59ZAM,2016 Summer Olympics,59,ZAM,Zambia,5,0,0,0,0
54ZAM,2012 Summer Olympics,54,ZAM,Zambia,5,0,0,0,0
53ZAM,2008 Summer Olympics,53,ZAM,Zambia,7,0,0,0,0
26ZAM,2004 Summer Olympics,26,ZAM,Zambia,4,0,0,0,0
25ZAM,2000 Summer Olympics,25,ZAM,Zambia,7,0,0,0,0
24ZAM,1996 Summer Olympics,24,ZAM,Zambia,4,0,1,0,1
23ZAM,1992 Summer Olympics,23,ZAM,Zambia,7,0,0,0,0
22ZAM,1988 Summer Olympics,22,ZAM,Zambia,29,0,0,0,0
21ZAM,1984 Summer Olympics,21,ZAM,Zambia,14,0,0,1,1
20ZAM,1980 Summer Olympics,20,ZAM,Zambia,38,0,0,0,0
18ZAM,1972 Summer Olympics,18,ZAM,Zambia,10,0,0,0,0
17ZAM,1968 Summer Olympics,17,ZAM,Zambia,7,0,0,0,0
16ZAM,1964 Summer Olympics,16,ZAM,Zambia,12,0,0,0,0
62UZB,2022 Winter Olympics,62,UZB,Uzbekistan,0,0,0,0,0
61UZB,2020 Summer Olympics,61,UZB,Uzbekistan,48,3,0,2,5
60UZB,2018 Winter Olympics,60,UZB,Uzbekistan,1,0,0,0,0
59UZB,2016 Summer Olympics,59,UZB,Uzbekistan,46,4,2,7,13
58UZB,2014 Winter Olympics,58,UZB,Uzbekistan,2,0,0,0,0
54UZB,2012 Summer Olympics,54,UZB,Uzbekistan,31,0,0,3,3
57UZB,2010 Winter Olympics,57,UZB,Uzbekistan,2,0,0,0,0
53UZB,2008 Summer Olympics,53,UZB,Uzbekistan,35,0,1,3,4
49UZB,2006 Winter Olympics,49,UZB,Uzbekistan,4,0,0,0,0
26UZB,2004 Summer Olympics,26,UZB,Uzbekistan,47,2,1,2,5
47UZB,2002 Winter Olympics,47,UZB,Uzbekistan,3,0,0,0,0
25UZB,2000 Summer Olympics,25,UZB,Uzbekistan,41,1,1,2,4
46UZB,1998 Winter Olympics,46,UZB,Uzbekistan,3,0,0,0,0
24UZB,1996 Summer Olympics,24,UZB,Uzbekistan,66,0,1,1,2
45UZB,1994 Winter Olympics,45,UZB,Uzbekistan,5,1,0,0,1
62ISV,2022 Winter Olympics,62,ISV,United States Virgin Islands,1,0,0,0,0
61ISV,2020 Summer Olympics,61,ISV,United States Virgin Islands,3,0,0,0,0
59ISV,2016 Summer Olympics,59,ISV,United States Virgin Islands,4,0,0,0,0
58ISV,2014 Winter Olympics,58,ISV,United States Virgin Islands,1,0,0,0,0
54ISV,2012 Summer Olympics,54,ISV,United States Virgin Islands,5,0,0,0,0
53ISV,2008 Summer Olympics,53,ISV,United States Virgin Islands,5,0,0,0,0
26ISV,2004 Summer Olympics,26,ISV,United States Virgin Islands,4,0,0,0,0
47ISV,2002 Winter Olympics,47,ISV,United States Virgin Islands,3,0,0,0,0
25ISV,2000 Summer Olympics,25,ISV,United States Virgin Islands,5,0,0,0,0
46ISV,1998 Winter Olympics,46,ISV,United States Virgin Islands,2,0,0,0,0
24ISV,1996 Summer Olympics,24,ISV,United States Virgin Islands,6,0,0,0,0
45ISV,1994 Winter Olympics,45,ISV,United States Virgin Islands,4,0,0,0,0
44ISV,1992 Winter Olympics,44,ISV,United States Virgin Islands,10,0,0,0,0
23ISV,1992 Summer Olympics,23,ISV,United States Virgin Islands,14,0,0,0,0
43ISV,1988 Winter Olympics,43,ISV,United States Virgin Islands,5,0,0,0,0
22ISV,1988 Summer Olympics,22,ISV,United States Virgin Islands,19,0,1,0,1
21ISV,1984 Summer Olympics,21,ISV,United States Virgin Islands,31,0,0,0,0
19ISV,1976 Summer Olympics,19,ISV,United States Virgin Islands,20,0,0,0,0
18ISV,1972 Summer Olympics,18,ISV,United States Virgin Islands,15,0,0,0,0
17ISV,1968 Summer Olympics,17,ISV,United States Virgin Islands,6,0,0,0,0
62NED,2022 Winter Olympics,62,NED,Netherlands,23,12,5,7,24
61NED,2020 Summer Olympics,61,NED,Netherlands,168,33,22,17,72
60NED,2018 Winter Olympics,60,NED,Netherlands,14,8,9,13,30
59NED,2016 Summer Olympics,59,NED,Netherlands,149,9,28,13,50
58NED,2014 Winter Olympics,58,NED,Netherlands,19,14,7,9,30
54NED,2012 Summer Olympics,54,NED,Netherlands,98,23,30,19,72
57NED,2010 Winter Olympics,57,NED,Netherlands,19,4,1,6,11
53NED,2008 Summer Olympics,53,NED,Netherlands,154,42,18,4,64
49NED,2006 Winter Olympics,49,NED,Netherlands,18,3,2,8,13
26NED,2004 Summer Olympics,26,NED,Netherlands,118,4,51,22,77
47NED,2002 Winter Olympics,47,NED,Netherlands,15,3,5,0,8
25NED,2000 Summer Olympics,25,NED,Netherlands,144,27,29,23,79
46NED,1998 Winter Olympics,46,NED,Netherlands,17,5,4,2,11
24NED,1996 Summer Olympics,24,NED,Netherlands,157,38,9,26,73
45NED,1994 Winter Olympics,45,NED,Netherlands,11,0,1,3,4
44NED,1992 Winter Olympics,44,NED,Netherlands,14,1,1,2,4
23NED,1992 Summer Olympics,23,NED,Netherlands,149,5,20,8,33
43NED,1988 Winter Olympics,43,NED,Netherlands,18,3,2,2,7
22NED,1988 Summer Olympics,22,NED,Netherlands,136,3,6,36,45
42NED,1984 Winter Olympics,42,NED,Netherlands,10,0,0,0,0
21NED,1984 Summer Olympics,21,NED,Netherlands,110,20,7,14,41
41NED,1980 Winter Olympics,41,NED,Netherlands,26,1,2,1,4
20NED,1980 Summer Olympics,20,NED,Netherlands,65,0,1,5,6
40NED,1976 Winter Olympics,40,NED,Netherlands,8,1,2,3,6
19NED,1976 Summer Olympics,19,NED,Netherlands,88,0,2,13,15
39NED,1972 Winter Olympics,39,NED,Netherlands,6,4,3,2,9
18NED,1972 Summer Olympics,18,NED,Netherlands,109,3,1,2,6
38NED,1968 Winter Olympics,38,NED,Netherlands,6,3,3,3,9
17NED,1968 Summer Olympics,17,NED,Netherlands,87,6,7,1,14
37NED,1964 Winter Olympics,37,NED,Netherlands,5,1,1,0,2
16NED,1964 Summer Olympics,16,NED,Netherlands,86,5,10,16,31
36NED,1960 Winter Olympics,36,NED,Netherlands,2,0,1,1,2
15NED,1960 Summer Olympics,15,NED,Netherlands,112,0,1,2,3
48NED,1956 Equestrian Olympics,48,NED,Netherlands,1,0,0,0,0
35NED,1956 Winter Olympics,35,NED,Netherlands,5,0,0,0,0
34NED,1952 Winter Olympics,34,NED,Netherlands,9,0,3,0,3
13NED,1952 Summer Olympics,13,NED,Netherlands,73,0,20,0,20
33NED,1948 Winter Olympics,33,NED,Netherlands,3,0,0,0,0
12NED,1948 Summer Olympics,12,NED,Netherlands,154,9,2,45,56
32NED,1936 Winter Olympics,32,NED,Netherlands,8,0,0,0,0
11NED,1936 Summer Olympics,11,NED,Netherlands,152,11,7,27,45
10NED,1932 Summer Olympics,10,NED,Netherlands,27,2,10,1,13
30NED,1928 Winter Olympics,30,NED,Netherlands,7,0,0,0,0
9NED,1928 Summer Olympics,9,NED,Netherlands,283,20,40,7,67
8NED,1924 Summer Olympics,8,NED,Netherlands,166,8,1,22,31
7NED,1920 Summer Olympics,7,NED,Netherlands,156,15,10,33,58
6NED,1912 Summer Olympics,6,NED,Netherlands,35,0,0,35,35
5NED,1908 Summer Olympics,5,NED,Netherlands,133,0,0,34,34
2NED,1900 Summer Olympics,2,NED,Netherlands,43,3,8,15,26
61VIE,2020 Summer Olympics,61,VIE,Vietnam,14,0,0,0,0
59VIE,2016 Summer Olympics,59,VIE,Vietnam,14,1,1,0,2
54VIE,2012 Summer Olympics,54,VIE,Vietnam,16,0,0,1,1
53VIE,2008 Summer Olympics,53,VIE,Vietnam,16,0,1,0,1
26VIE,2004 Summer Olympics,26,VIE,Vietnam,11,0,0,0,0
25VIE,2000 Summer Olympics,25,VIE,Vietnam,6,0,1,0,1
24VIE,1996 Summer Olympics,24,VIE,Vietnam,6,0,0,0,0
23VIE,1992 Summer Olympics,23,VIE,Vietnam,5,0,0,0,0
22VIE,1988 Summer Olympics,22,VIE,Vietnam,8,0,0,0,0
20VIE,1980 Summer Olympics,20,VIE,Vietnam,30,0,0,0,0
62CHN,2022 Winter Olympics,62,CHN,People's Republic of China,136,14,6,6,26
61CHN,2020 Summer Olympics,61,CHN,People's Republic of China,288,58,49,38,145
60CHN,2018 Winter Olympics,60,CHN,People's Republic of China,52,1,11,2,14
59CHN,2016 Summer Olympics,59,CHN,People's Republic of China,279,46,30,37,113
58CHN,2014 Winter Olympics,58,CHN,People's Republic of China,32,3,4,6,13
54CHN,2012 Summer Olympics,54,CHN,People's Republic of China,220,57,44,28,129
57CHN,2010 Winter Olympics,57,CHN,People's Republic of China,59,10,3,8,21
53CHN,2008 Summer Olympics,53,CHN,People's Republic of China,457,71,56,59,186
49CHN,2006 Winter Olympics,49,CHN,People's Republic of China,46,2,5,6,13
26CHN,2004 Summer Olympics,26,CHN,People's Republic of China,308,52,27,15,94
47CHN,2002 Winter Olympics,47,CHN,People's Republic of China,37,2,6,9,17
25CHN,2000 Summer Olympics,25,CHN,People's Republic of China,193,39,23,17,79
46CHN,1998 Winter Olympics,46,CHN,People's Republic of China,49,0,10,6,16
24CHN,1996 Summer Olympics,24,CHN,People's Republic of China,242,19,76,17,112
45CHN,1994 Winter Olympics,45,CHN,People's Republic of China,14,0,1,2,3
44CHN,1992 Winter Olympics,44,CHN,People's Republic of China,25,0,3,0,3
23CHN,1992 Summer Olympics,23,CHN,People's Republic of China,178,18,46,19,83
43CHN,1988 Winter Olympics,43,CHN,People's Republic of China,15,0,0,0,0
22CHN,1988 Summer Olympics,22,CHN,People's Republic of China,235,6,16,31,53
42CHN,1984 Winter Olympics,42,CHN,People's Republic of China,27,0,0,0,0
21CHN,1984 Summer Olympics,21,CHN,People's Republic of China,221,26,13,39,78
41CHN,1980 Winter Olympics,41,CHN,People's Republic of China,24,0,0,0,0
13CHN,1952 Summer Olympics,13,CHN,People's Republic of China,0,0,0,0,0
12CHN,1948 Summer Olympics,12,CHN,People's Republic of China,35,0,0,0,0
11CHN,1936 Summer Olympics,11,CHN,People's Republic of China,68,0,0,0,0
10CHN,1932 Summer Olympics,10,CHN,People's Republic of China,1,0,0,0,0
61YEM,2020 Summer Olympics,61,YEM,Yemen,4,0,0,0,0
59YEM,2016 Summer Olympics,59,YEM,Yemen,3,0,0,0,0
54YEM,2012 Summer Olympics,54,YEM,Yemen,3,0,0,0,0
53YEM,2008 Summer Olympics,53,YEM,Yemen,5,0,0,0,0
26YEM,2004 Summer Olympics,26,YEM,Yemen,3,0,0,0,0
25YEM,2000 Summer Olympics,25,YEM,Yemen,2,0,0,0,0
24YEM,1996 Summer Olympics,24,YEM,Yemen,5,0,0,0,0
23YEM,1992 Summer Olympics,23,YEM,Yemen,9,0,0,0,0
61VAN,2020 Summer Olympics,61,VAN,Vanuatu,2,0,0,0,0
59VAN,2016 Summer Olympics,59,VAN,Vanuatu,3,0,0,0,0
54VAN,2012 Summer Olympics,54,VAN,Vanuatu,5,0,0,0,0
53VAN,2008 Summer Olympics,53,VAN,Vanuatu,2,0,0,0,0
26VAN,2004 Summer Olympics,26,VAN,Vanuatu,2,0,0,0,0
25VAN,2000 Summer Olympics,25,VAN,Vanuatu,2,0,0,0,0
24VAN,1996 Summer Olympics,24,VAN,Vanuatu,2,0,0,0,0
23VAN,1992 Summer Olympics,23,VAN,Vanuatu,5,0,0,0,0
22VAN,1988 Summer Olympics,22,VAN,Vanuatu,6,0,0,0,0
62ROU,2022 Winter Olympics,62,ROU,Romania,13,0,0,0,0
61ROU,2020 Summer Olympics,61,ROU,Romania,77,2,7,0,9
60ROU,2018 Winter Olympics,60,ROU,Romania,13,0,0,0,0
59ROU,2016 Summer Olympics,59,ROU,Romania,59,4,2,10,16
58ROU,2014 Winter Olympics,58,ROU,Romania,13,0,0,0,0
54ROU,2012 Summer Olympics,54,ROU,Romania,72,2,7,5,14
57ROU,2010 Winter Olympics,57,ROU,Romania,17,0,0,0,0
53ROU,2008 Summer Olympics,53,ROU,Romania,61,5,1,17,23
49ROU,2006 Winter Olympics,49,ROU,Romania,14,0,0,0,0
26ROU,2004 Summer Olympics,26,ROU,Romania,52,23,5,11,39
47ROU,2002 Winter Olympics,47,ROU,Romania,16,0,0,0,0
25ROU,2000 Summer Olympics,25,ROU,Romania,83,27,6,13,46
46ROU,1998 Winter Olympics,46,ROU,Romania,6,0,0,0,0
24ROU,1996 Summer Olympics,24,ROU,Romania,93,13,10,15,38
45ROU,1994 Winter Olympics,45,ROU,Romania,14,0,0,0,0
44ROU,1992 Winter Olympics,44,ROU,Romania,13,0,0,0,0
23ROU,1992 Summer Olympics,23,ROU,Romania,130,8,31,14,53
43ROU,1988 Winter Olympics,43,ROU,Romania,9,0,0,0,0
22ROU,1988 Summer Olympics,22,ROU,Romania,39,8,34,16,58
42ROU,1984 Winter Olympics,42,ROU,Romania,16,0,0,0,0
21ROU,1984 Summer Olympics,21,ROU,Romania,71,40,31,35,106
41ROU,1980 Winter Olympics,41,ROU,Romania,23,0,0,0,0
20ROU,1980 Summer Olympics,20,ROU,Romania,157,7,15,48,70
40ROU,1976 Winter Olympics,40,ROU,Romania,25,0,0,0,0
19ROU,1976 Summer Olympics,19,ROU,Romania,104,4,28,23,55
39ROU,1972 Winter Olympics,39,ROU,Romania,9,0,0,0,0
18ROU,1972 Summer Olympics,18,ROU,Romania,116,3,10,29,42
38ROU,1968 Winter Olympics,38,ROU,Romania,16,0,0,2,2
17ROU,1968 Summer Olympics,17,ROU,Romania,51,5,9,9,23
37ROU,1964 Winter Olympics,37,ROU,Romania,27,0,0,0,0
16ROU,1964 Summer Olympics,16,ROU,Romania,105,2,4,10,16
15ROU,1960 Summer Olympics,15,ROU,Romania,83,3,1,11,15
48ROU,1956 Equestrian Olympics,48,ROU,Romania,5,0,0,0,0
35ROU,1956 Winter Olympics,35,ROU,Romania,17,0,0,0,0
14ROU,1956 Summer Olympics,14,ROU,Romania,33,6,3,10,19
34ROU,1952 Winter Olympics,34,ROU,Romania,10,0,0,0,0
13ROU,1952 Summer Olympics,13,ROU,Romania,142,1,1,2,4
33ROU,1948 Winter Olympics,33,ROU,Romania,11,0,0,0,0
32ROU,1936 Winter Olympics,32,ROU,Romania,17,0,0,0,0
11ROU,1936 Summer Olympics,11,ROU,Romania,60,0,1,0,1
31ROU,1932 Winter Olympics,31,ROU,Romania,4,0,0,0,0
10ROU,1932 Summer Olympics,10,ROU,Romania,1,0,0,0,0
30ROU,1928 Winter Olympics,30,ROU,Romania,14,0,0,0,0
9ROU,1928 Summer Olympics,9,ROU,Romania,20,0,0,0,0
8ROU,1924 Summer Olympics,8,ROU,Romania,53,0,0,22,22
2ROU,1900 Summer Olympics,2,ROU,Romania,1,0,0,0,0
62KOR,2022 Winter Olympics,62,KOR,Republic of Korea,25,2,13,2,17
61KOR,2020 Summer Olympics,61,KOR,Republic of Korea,168,14,7,17,38
60KOR,2018 Winter Olympics,60,KOR,Republic of Korea,86,9,18,4,31
59KOR,2016 Summer Olympics,59,KOR,Republic of Korea,140,13,3,10,26
58KOR,2014 Winter Olympics,58,KOR,Republic of Korea,49,7,6,2,15
54KOR,2012 Summer Olympics,54,KOR,Republic of Korea,164,18,14,35,67
57KOR,2010 Winter Olympics,57,KOR,Republic of Korea,29,6,10,2,18
53KOR,2008 Summer Olympics,53,KOR,Republic of Korea,180,41,12,26,79
49KOR,2006 Winter Olympics,49,KOR,Republic of Korea,21,14,3,2,19
26KOR,2004 Summer Olympics,26,KOR,Republic of Korea,185,14,28,10,52
47KOR,2002 Winter Olympics,47,KOR,Republic of Korea,30,6,2,0,8
25KOR,2000 Summer Olympics,25,KOR,Republic of Korea,188,12,26,35,73
46KOR,1998 Winter Olympics,46,KOR,Republic of Korea,25,7,5,2,14
24KOR,1996 Summer Olympics,24,KOR,Republic of Korea,246,10,49,7,66
45KOR,1994 Winter Olympics,45,KOR,Republic of Korea,11,8,1,1,10
44KOR,1992 Winter Olympics,44,KOR,Republic of Korea,17,6,1,1,8
23KOR,1992 Summer Olympics,23,KOR,Republic of Korea,188,31,5,16,52
43KOR,1988 Winter Olympics,43,KOR,Republic of Korea,25,0,0,0,0
22KOR,1988 Summer Olympics,22,KOR,Republic of Korea,412,31,39,12,82
42KOR,1984 Winter Olympics,42,KOR,Republic of Korea,12,0,0,0,0
21KOR,1984 Summer Olympics,21,KOR,Republic of Korea,200,6,31,7,44
41KOR,1980 Winter Olympics,41,KOR,Republic of Korea,8,0,0,0,0
40KOR,1976 Winter Olympics,40,KOR,Republic of Korea,3,0,0,0,0
19KOR,1976 Summer Olympics,19,KOR,Republic of Korea,34,1,1,15,17
39KOR,1972 Winter Olympics,39,KOR,Republic of Korea,5,0,0,0,0
18KOR,1972 Summer Olympics,18,KOR,Republic of Korea,41,0,1,0,1
38KOR,1968 Winter Olympics,38,KOR,Republic of Korea,7,0,0,0,0
17KOR,1968 Summer Olympics,17,KOR,Republic of Korea,37,0,1,1,2
37KOR,1964 Winter Olympics,37,KOR,Republic of Korea,6,0,0,0,0
16KOR,1964 Summer Olympics,16,KOR,Republic of Korea,150,0,2,1,3
36KOR,1960 Winter Olympics,36,KOR,Republic of Korea,6,0,0,0,0
15KOR,1960 Summer Olympics,15,KOR,Republic of Korea,31,0,0,0,0
35KOR,1956 Winter Olympics,35,KOR,Republic of Korea,4,0,0,0,0
14KOR,1956 Summer Olympics,14,KOR,Republic of Korea,26,0,1,1,2
13KOR,1952 Summer Olympics,13,KOR,Republic of Korea,11,0,0,2,2
33KOR,1948 Winter Olympics,33,KOR,Republic of Korea,3,0,0,0,0
12KOR,1948 Summer Olympics,12,KOR,Republic of Korea,50,0,0,2,2
15WIF,1960 Summer Olympics,15,WIF,West Indies Federation,6,0,0,7,7
61TAN,2020 Summer Olympics,61,TAN,United Republic of Tanzania,2,0,0,0,0
59TAN,2016 Summer Olympics,59,TAN,United Republic of Tanzania,5,0,0,0,0
54TAN,2012 Summer Olympics,54,TAN,United Republic of Tanzania,3,0,0,0,0
53TAN,2008 Summer Olympics,53,TAN,United Republic of Tanzania,7,0,0,0,0
26TAN,2004 Summer Olympics,26,TAN,United Republic of Tanzania,6,0,0,0,0
25TAN,2000 Summer Olympics,25,TAN,United Republic of Tanzania,3,0,0,0,0
24TAN,1996 Summer Olympics,24,TAN,United Republic of Tanzania,5,0,0,0,0
23TAN,1992 Summer Olympics,23,TAN,United Republic of Tanzania,4,0,0,0,0
22TAN,1988 Summer Olympics,22,TAN,United Republic of Tanzania,8,0,0,0,0
21TAN,1984 Summer Olympics,21,TAN,United Republic of Tanzania,11,0,0,0,0
20TAN,1980 Summer Olympics,20,TAN,United Republic of Tanzania,40,0,2,0,2
18TAN,1972 Summer Olympics,18,TAN,United Republic of Tanzania,12,0,0,0,0
17TAN,1968 Summer Olympics,17,TAN,United Republic of Tanzania,4,0,0,0,0
16TAN,1964 Summer Olympics,16,TAN,United Republic of Tanzania,4,0,0,0,0
62NOR,2022 Winter Olympics,62,NOR,Norway,41,29,12,18,59
61NOR,2020 Summer Olympics,61,NOR,Norway,68,5,2,16,23
60NOR,2018 Winter Olympics,60,NOR,Norway,49,27,23,18,68
59NOR,2016 Summer Olympics,59,NOR,Norway,32,0,0,19,19
58NOR,2014 Winter Olympics,58,NOR,Norway,65,18,9,9,36
54NOR,2012 Summer Olympics,54,NOR,Norway,35,16,1,1,18
57NOR,2010 Winter Olympics,57,NOR,Norway,67,16,15,9,40
53NOR,2008 Summer Olympics,53,NOR,Norway,58,16,5,1,22
49NOR,2006 Winter Olympics,49,NOR,Norway,31,2,9,12,23
26NOR,2004 Summer Olympics,26,NOR,Norway,29,5,0,2,7
47NOR,2002 Winter Olympics,47,NOR,Norway,38,23,11,7,41
25NOR,2000 Summer Olympics,25,NOR,Norway,53,25,4,19,48
46NOR,1998 Winter Olympics,46,NOR,Norway,36,16,16,12,44
24NOR,1996 Summer Olympics,24,NOR,Norway,69,2,3,21,26
45NOR,1994 Winter Olympics,45,NOR,Norway,37,10,19,5,34
44NOR,1992 Winter Olympics,44,NOR,Norway,65,12,11,5,28
23NOR,1992 Summer Olympics,23,NOR,Norway,63,2,22,1,25
43NOR,1988 Winter Olympics,43,NOR,Norway,58,0,6,5,11
22NOR,1988 Summer Olympics,22,NOR,Norway,48,2,21,0,23
42NOR,1984 Winter Olympics,42,NOR,Norway,35,6,5,4,15
21NOR,1984 Summer Olympics,21,NOR,Norway,97,0,1,3,4
41NOR,1980 Winter Olympics,41,NOR,Norway,43,1,6,9,16
40NOR,1976 Winter Olympics,40,NOR,Norway,30,3,6,1,10
19NOR,1976 Summer Olympics,19,NOR,Norway,43,2,4,0,6
39NOR,1972 Winter Olympics,39,NOR,Norway,39,2,8,7,17
18NOR,1972 Summer Olympics,18,NOR,Norway,90,2,2,4,8
38NOR,1968 Winter Olympics,38,NOR,Norway,43,11,9,2,22
17NOR,1968 Summer Olympics,17,NOR,Norway,39,4,2,0,6
37NOR,1964 Winter Olympics,37,NOR,Norway,40,3,6,6,15
16NOR,1964 Summer Olympics,16,NOR,Norway,17,0,0,0,0
36NOR,1960 Winter Olympics,36,NOR,Norway,16,3,6,0,9
15NOR,1960 Summer Olympics,15,NOR,Norway,29,2,0,0,2
48NOR,1956 Equestrian Olympics,48,NOR,Norway,3,0,0,0,0
35NOR,1956 Winter Olympics,35,NOR,Norway,27,2,1,1,4
14NOR,1956 Summer Olympics,14,NOR,Norway,8,1,0,2,3
34NOR,1952 Winter Olympics,34,NOR,Norway,72,7,6,6,19
13NOR,1952 Summer Olympics,13,NOR,Norway,79,5,8,0,13
33NOR,1948 Winter Olympics,33,NOR,Norway,46,4,3,6,13
12NOR,1948 Summer Olympics,12,NOR,Norway,72,3,4,11,18
32NOR,1936 Winter Olympics,32,NOR,Norway,22,7,8,3,18
11NOR,1936 Summer Olympics,11,NOR,Norway,70,1,12,23,36
31NOR,1932 Winter Olympics,31,NOR,Norway,12,3,4,3,10
10NOR,1932 Summer Olympics,10,NOR,Norway,5,0,0,0,0
30NOR,1928 Winter Olympics,30,NOR,Norway,21,6,4,5,15
9NOR,1928 Summer Olympics,9,NOR,Norway,43,4,4,1,9
29NOR,1924 Winter Olympics,29,NOR,Norway,14,4,7,6,17
8NOR,1924 Summer Olympics,8,NOR,Norway,62,14,5,3,22
7NOR,1920 Summer Olympics,7,NOR,Norway,172,58,53,27,138
6NOR,1912 Summer Olympics,6,NOR,Norway,177,39,7,34,80
5NOR,1908 Summer Olympics,5,NOR,Norway,72,7,32,3,42
2NOR,1900 Summer Olympics,2,NOR,Norway,7,0,6,3,9
61UGA,2020 Summer Olympics,61,UGA,Uganda,17,2,1,1,4
59UGA,2016 Summer Olympics,59,UGA,Uganda,16,0,0,0,0
54UGA,2012 Summer Olympics,54,UGA,Uganda,10,1,0,0,1
53UGA,2008 Summer Olympics,53,UGA,Uganda,9,0,0,0,0
26UGA,2004 Summer Olympics,26,UGA,Uganda,10,0,0,0,0
25UGA,2000 Summer Olympics,25,UGA,Uganda,9,0,0,0,0
24UGA,1996 Summer Olympics,24,UGA,Uganda,7,0,0,1,1
23UGA,1992 Summer Olympics,23,UGA,Uganda,7,0,0,0,0
22UGA,1988 Summer Olympics,22,UGA,Uganda,18,0,0,0,0
21UGA,1984 Summer Olympics,21,UGA,Uganda,21,0,0,0,0
20UGA,1980 Summer Olympics,20,UGA,Uganda,12,0,1,0,1
18UGA,1972 Summer Olympics,18,UGA,Uganda,29,1,1,0,2
17UGA,1968 Summer Olympics,17,UGA,Uganda,9,0,1,1,2
16UGA,1964 Summer Olympics,16,UGA,Uganda,10,0,0,0,0
15UGA,1960 Summer Olympics,15,UGA,Uganda,11,0,0,0,0
14UGA,1956 Summer Olympics,14,UGA,Uganda,3,0,0,0,0
61TUN,2020 Summer Olympics,61,TUN,Tunisia,41,1,1,0,2
59TUN,2016 Summer Olympics,59,TUN,Tunisia,34,0,0,3,3
54TUN,2012 Summer Olympics,54,TUN,Tunisia,66,2,0,1,3
53TUN,2008 Summer Olympics,53,TUN,Tunisia,24,1,0,0,1
26TUN,2004 Summer Olympics,26,TUN,Tunisia,50,0,0,0,0
25TUN,2000 Summer Olympics,25,TUN,Tunisia,39,0,0,0,0
24TUN,1996 Summer Olympics,24,TUN,Tunisia,52,0,0,1,1
23TUN,1992 Summer Olympics,23,TUN,Tunisia,11,0,0,0,0
22TUN,1988 Summer Olympics,22,TUN,Tunisia,37,0,0,0,0
21TUN,1984 Summer Olympics,21,TUN,Tunisia,23,0,0,0,0
19TUN,1976 Summer Olympics,19,TUN,Tunisia,13,0,0,0,0
18TUN,1972 Summer Olympics,18,TUN,Tunisia,34,0,1,0,1
17TUN,1968 Summer Olympics,17,TUN,Tunisia,4,1,0,1,2
16TUN,1964 Summer Olympics,16,TUN,Tunisia,9,0,1,1,2
15TUN,1960 Summer Olympics,15,TUN,Tunisia,48,0,0,0,0
6UNK,1912 Summer Olympics,6,UNK,Unknown,2,0,0,0,0
2UNK,1900 Summer Olympics,2,UNK,Unknown,4,0,0,0,0
44EUN,1992 Winter Olympics,44,EUN,Unified Team,62,36,10,15,61
23EUN,1992 Summer Olympics,23,EUN,Unified Team,308,96,65,69,230
62TTO,2022 Winter Olympics,62,TTO,Trinidad and Tobago,3,0,0,0,0
61TTO,2020 Summer Olympics,61,TTO,Trinidad and Tobago,17,0,0,0,0
59TTO,2016 Summer Olympics,59,TTO,Trinidad and Tobago,10,0,0,1,1
54TTO,2012 Summer Olympics,54,TTO,Trinidad and Tobago,14,1,4,5,10
53TTO,2008 Summer Olympics,53,TTO,Trinidad and Tobago,18,5,1,0,6
26TTO,2004 Summer Olympics,26,TTO,Trinidad and Tobago,15,0,0,1,1
47TTO,2002 Winter Olympics,47,TTO,Trinidad and Tobago,2,0,0,0,0
25TTO,2000 Summer Olympics,25,TTO,Trinidad and Tobago,15,0,1,1,2
46TTO,1998 Winter Olympics,46,TTO,Trinidad and Tobago,0,0,0,0,0
24TTO,1996 Summer Olympics,24,TTO,Trinidad and Tobago,9,0,0,2,2
45TTO,1994 Winter Olympics,45,TTO,Trinidad and Tobago,2,0,0,0,0
23TTO,1992 Summer Olympics,23,TTO,Trinidad and Tobago,3,0,0,0,0
22TTO,1988 Summer Olympics,22,TTO,Trinidad and Tobago,4,0,0,0,0
21TTO,1984 Summer Olympics,21,TTO,Trinidad and Tobago,14,0,0,0,0
20TTO,1980 Summer Olympics,20,TTO,Trinidad and Tobago,4,0,0,0,0
19TTO,1976 Summer Olympics,19,TTO,Trinidad and Tobago,9,1,0,0,1
18TTO,1972 Summer Olympics,18,TTO,Trinidad and Tobago,16,0,0,0,0
17TTO,1968 Summer Olympics,17,TTO,Trinidad and Tobago,17,0,0,0,0
16TTO,1964 Summer Olympics,16,TTO,Trinidad and Tobago,13,0,1,7,8
14TTO,1956 Summer Olympics,14,TTO,Trinidad and Tobago,4,0,0,0,0
13TTO,1952 Summer Olympics,13,TTO,Trinidad and Tobago,1,0,0,2,2
12TTO,1948 Summer Olympics,12,TTO,Trinidad and Tobago,5,0,1,0,1
62THA,2022 Winter Olympics,62,THA,Thailand,1,0,0,0,0
61THA,2020 Summer Olympics,61,THA,Thailand,27,1,0,1,2
60THA,2018 Winter Olympics,60,THA,Thailand,4,0,0,0,0
59THA,2016 Summer Olympics,59,THA,Thailand,37,2,2,2,6
58THA,2014 Winter Olympics,58,THA,Thailand,2,0,0,0,0
54THA,2012 Summer Olympics,54,THA,Thailand,25,0,2,2,4
53THA,2008 Summer Olympics,53,THA,Thailand,35,2,2,2,6
49THA,2006 Winter Olympics,49,THA,Thailand,0,0,0,0,0
26THA,2004 Summer Olympics,26,THA,Thailand,24,3,1,4,8
47THA,2002 Winter Olympics,47,THA,Thailand,1,0,0,0,0
25THA,2000 Summer Olympics,25,THA,Thailand,39,1,0,2,3
24THA,1996 Summer Olympics,24,THA,Thailand,27,1,0,1,2
23THA,1992 Summer Olympics,23,THA,Thailand,40,0,0,1,1
22THA,1988 Summer Olympics,22,THA,Thailand,12,0,0,1,1
21THA,1984 Summer Olympics,21,THA,Thailand,34,0,1,0,1
19THA,1976 Summer Olympics,19,THA,Thailand,34,0,0,1,1
18THA,1972 Summer Olympics,18,THA,Thailand,27,0,0,0,0
17THA,1968 Summer Olympics,17,THA,Thailand,32,0,0,0,0
16THA,1964 Summer Olympics,16,THA,Thailand,52,0,0,0,0
15THA,1960 Summer Olympics,15,THA,Thailand,15,0,0,0,0
14THA,1956 Summer Olympics,14,THA,Thailand,40,0,0,0,0
13THA,1952 Summer Olympics,13,THA,Thailand,8,0,0,0,0
61RSA,2020 Summer Olympics,61,RSA,South Africa,146,1,2,0,3
60RSA,2018 Winter Olympics,60,RSA,South Africa,1,0,0,0,0
59RSA,2016 Summer Olympics,59,RSA,South Africa,106,2,7,14,23
54RSA,2012 Summer Olympics,54,RSA,South Africa,94,7,1,1,9
57RSA,2010 Winter Olympics,57,RSA,South Africa,1,0,0,0,0
53RSA,2008 Summer Olympics,53,RSA,South Africa,110,0,1,0,1
49RSA,2006 Winter Olympics,49,RSA,South Africa,2,0,0,0,0
26RSA,2004 Summer Olympics,26,RSA,South Africa,73,4,3,3,10
47RSA,2002 Winter Olympics,47,RSA,South Africa,0,0,0,0,0
25RSA,2000 Summer Olympics,25,RSA,South Africa,104,0,2,3,5
46RSA,1998 Winter Olympics,46,RSA,South Africa,2,0,0,0,0
24RSA,1996 Summer Olympics,24,RSA,South Africa,71,3,1,1,5
45RSA,1994 Winter Olympics,45,RSA,South Africa,2,0,0,0,0
23RSA,1992 Summer Olympics,23,RSA,South Africa,93,0,3,0,3
36RSA,1960 Winter Olympics,36,RSA,South Africa,4,0,0,0,0
15RSA,1960 Summer Olympics,15,RSA,South Africa,39,0,1,2,3
14RSA,1956 Summer Olympics,14,RSA,South Africa,36,0,0,7,7
13RSA,1952 Summer Olympics,13,RSA,South Africa,59,2,8,4,14
12RSA,1948 Summer Olympics,12,RSA,South Africa,33,2,2,2,6
11RSA,1936 Summer Olympics,11,RSA,South Africa,34,0,1,0,1
10RSA,1932 Summer Olympics,10,RSA,South Africa,10,2,0,3,5
9RSA,1928 Summer Olympics,9,RSA,South Africa,22,1,0,6,7
8RSA,1924 Summer Olympics,8,RSA,South Africa,23,1,1,1,3
7RSA,1920 Summer Olympics,7,RSA,South Africa,34,3,12,6,21
6RSA,1912 Summer Olympics,6,RSA,South Africa,19,5,2,0,7
5RSA,1908 Summer Olympics,5,RSA,South Africa,18,1,1,0,2
3RSA,1904 Summer Olympics,3,RSA,South Africa,8,0,0,0,0
61UAE,2020 Summer Olympics,61,UAE,United Arab Emirates,2,0,0,0,0
59UAE,2016 Summer Olympics,59,UAE,United Arab Emirates,9,0,0,1,1
54UAE,2012 Summer Olympics,54,UAE,United Arab Emirates,29,0,0,0,0
53UAE,2008 Summer Olympics,53,UAE,United Arab Emirates,5,0,0,0,0
26UAE,2004 Summer Olympics,26,UAE,United Arab Emirates,2,1,0,0,1
25UAE,2000 Summer Olympics,25,UAE,United Arab Emirates,4,0,0,0,0
24UAE,1996 Summer Olympics,24,UAE,United Arab Emirates,4,0,0,0,0
23UAE,1992 Summer Olympics,23,UAE,United Arab Emirates,9,0,0,0,0
22UAE,1988 Summer Olympics,22,UAE,United Arab Emirates,12,0,0,0,0
21UAE,1984 Summer Olympics,21,UAE,United Arab Emirates,8,0,0,0,0
59RUS,2016 Summer Olympics,59,RUS,Russian Federation,114,53,28,35,116
58RUS,2014 Winter Olympics,58,RUS,Russian Federation,97,24,18,13,55
54RUS,2012 Summer Olympics,54,RUS,Russian Federation,219,44,29,45,118
57RUS,2010 Winter Olympics,57,RUS,Russian Federation,83,6,5,14,25
53RUS,2008 Summer Olympics,53,RUS,Russian Federation,270,41,33,48,122
49RUS,2006 Winter Olympics,49,RUS,Russian Federation,83,16,12,13,41
26RUS,2004 Summer Olympics,26,RUS,Russian Federation,259,48,51,96,195
47RUS,2002 Winter Olympics,47,RUS,Russian Federation,98,6,5,29,40
25RUS,2000 Summer Olympics,25,RUS,Russian Federation,277,66,68,54,188
46RUS,1998 Winter Olympics,46,RUS,Russian Federation,84,14,33,6,53
24RUS,1996 Summer Olympics,24,RUS,Russian Federation,380,36,45,34,115
45RUS,1994 Winter Olympics,45,RUS,Russian Federation,112,19,13,4,36
8RUS,1924 Summer Olympics,8,RUS,Russian Federation,3,0,0,0,0
6RUS,1912 Summer Olympics,6,RUS,Russian Federation,172,0,5,9,14
5RUS,1908 Summer Olympics,5,RUS,Russian Federation,7,1,2,0,3
2RUS,1900 Summer Olympics,2,RUS,Russian Federation,6,0,0,0,0
15UAR,1960 Summer Olympics,15,UAR,United Arab Republic,40,0,1,1,2
61BAH,2020 Summer Olympics,61,BAH,The Bahamas,7,2,0,0,2
59BAH,2016 Summer Olympics,59,BAH,The Bahamas,16,1,0,5,6
54BAH,2012 Summer Olympics,54,BAH,The Bahamas,9,4,0,0,4
53BAH,2008 Summer Olympics,53,BAH,The Bahamas,13,0,6,1,7
26BAH,2004 Summer Olympics,26,BAH,The Bahamas,10,1,0,1,2
25BAH,2000 Summer Olympics,25,BAH,The Bahamas,10,6,0,5,11
24BAH,1996 Summer Olympics,24,BAH,The Bahamas,16,0,5,0,5
23BAH,1992 Summer Olympics,23,BAH,The Bahamas,9,0,0,1,1
22BAH,1988 Summer Olympics,22,BAH,The Bahamas,9,0,0,0,0
21BAH,1984 Summer Olympics,21,BAH,The Bahamas,20,0,0,0,0
19BAH,1976 Summer Olympics,19,BAH,The Bahamas,8,0,0,0,0
18BAH,1972 Summer Olympics,18,BAH,The Bahamas,13,0,0,0,0
17BAH,1968 Summer Olympics,17,BAH,The Bahamas,11,0,0,0,0
16BAH,1964 Summer Olympics,16,BAH,The Bahamas,4,2,0,0,2
15BAH,1960 Summer Olympics,15,BAH,The Bahamas,9,0,0,0,0
14BAH,1956 Summer Olympics,14,BAH,The Bahamas,1,0,0,2,2
13BAH,1952 Summer Olympics,13,BAH,The Bahamas,7,0,0,0,0
61TUV,2020 Summer Olympics,61,TUV,Tuvalu,2,0,0,0,0
59TUV,2016 Summer Olympics,59,TUV,Tuvalu,1,0,0,0,0
54TUV,2012 Summer Olympics,54,TUV,Tuvalu,2,0,0,0,0
53TUV,2008 Summer Olympics,53,TUV,Tuvalu,3,0,0,0,0
62JPN,2022 Winter Olympics,62,JPN,Japan,55,3,13,21,37
61JPN,2020 Summer Olympics,61,JPN,Japan,472,68,41,22,131
60JPN,2018 Winter Olympics,60,JPN,Japan,71,7,5,8,20
59JPN,2016 Summer Olympics,59,JPN,Japan,248,17,13,35,65
58JPN,2014 Winter Olympics,58,JPN,Japan,70,1,4,6,11
54JPN,2012 Summer Olympics,54,JPN,Japan,204,7,48,33,88
57JPN,2010 Winter Olympics,57,JPN,Japan,46,0,6,2,8
53JPN,2008 Summer Olympics,53,JPN,Japan,230,23,17,12,52
49JPN,2006 Winter Olympics,49,JPN,Japan,63,1,0,0,1
26JPN,2004 Summer Olympics,26,JPN,Japan,229,21,20,53,94
47JPN,2002 Winter Olympics,47,JPN,Japan,50,0,1,1,2
25JPN,2000 Summer Olympics,25,JPN,Japan,186,5,31,8,44
46JPN,1998 Winter Olympics,46,JPN,Japan,120,8,1,4,13
24JPN,1996 Summer Olympics,24,JPN,Japan,244,3,26,14,43
45JPN,1994 Winter Olympics,45,JPN,Japan,27,3,5,2,10
44JPN,1992 Winter Olympics,44,JPN,Japan,51,3,2,8,13
23JPN,1992 Summer Olympics,23,JPN,Japan,207,3,8,36,47
43JPN,1988 Winter Olympics,43,JPN,Japan,47,0,0,1,1
22JPN,1988 Summer Olympics,22,JPN,Japan,216,4,3,13,20
42JPN,1984 Winter Olympics,42,JPN,Japan,33,0,1,0,1
21JPN,1984 Summer Olympics,21,JPN,Japan,242,10,8,31,49
41JPN,1980 Winter Olympics,41,JPN,Japan,28,0,1,0,1
40JPN,1976 Winter Olympics,40,JPN,Japan,34,0,0,0,0
19JPN,1976 Summer Olympics,19,JPN,Japan,167,25,6,10,41
39JPN,1972 Winter Olympics,39,JPN,Japan,64,1,1,1,3
18JPN,1972 Summer Olympics,18,JPN,Japan,137,29,19,8,56
38JPN,1968 Winter Olympics,38,JPN,Japan,48,0,0,0,0
17JPN,1968 Summer Olympics,17,JPN,Japan,122,16,29,24,69
37JPN,1964 Winter Olympics,37,JPN,Japan,30,0,0,0,0
16JPN,1964 Summer Olympics,16,JPN,Japan,379,32,5,28,65
36JPN,1960 Winter Olympics,36,JPN,Japan,37,0,0,0,0
15JPN,1960 Summer Olympics,15,JPN,Japan,142,9,10,12,31
48JPN,1956 Equestrian Olympics,48,JPN,Japan,2,0,0,0,0
35JPN,1956 Winter Olympics,35,JPN,Japan,6,0,1,0,1
14JPN,1956 Summer Olympics,14,JPN,Japan,109,4,15,5,24
34JPN,1952 Winter Olympics,34,JPN,Japan,13,0,0,0,0
13JPN,1952 Summer Olympics,13,JPN,Japan,72,1,12,2,15
32JPN,1936 Winter Olympics,32,JPN,Japan,31,0,0,0,0
11JPN,1936 Summer Olympics,11,JPN,Japan,202,11,4,10,25
31JPN,1932 Winter Olympics,31,JPN,Japan,15,0,0,0,0
10JPN,1932 Summer Olympics,10,JPN,Japan,156,10,19,4,33
30JPN,1928 Winter Olympics,30,JPN,Japan,6,0,0,0,0
9JPN,1928 Summer Olympics,9,JPN,Japan,40,2,6,1,9
8JPN,1924 Summer Olympics,8,JPN,Japan,17,0,0,1,1
7JPN,1920 Summer Olympics,7,JPN,Japan,14,0,3,0,3
6JPN,1912 Summer Olympics,6,JPN,Japan,2,0,0,0,0
61TKM,2020 Summer Olympics,61,TKM,Turkmenistan,4,0,1,0,1
59TKM,2016 Summer Olympics,59,TKM,Turkmenistan,8,0,0,0,0
54TKM,2012 Summer Olympics,54,TKM,Turkmenistan,9,0,0,0,0
53TKM,2008 Summer Olympics,53,TKM,Turkmenistan,7,0,0,0,0
26TKM,2004 Summer Olympics,26,TKM,Turkmenistan,5,0,0,0,0
25TKM,2000 Summer Olympics,25,TKM,Turkmenistan,5,0,0,0,0
24TKM,1996 Summer Olympics,24,TKM,Turkmenistan,7,0,0,0,0
61TGA,2020 Summer Olympics,61,TGA,Tonga,4,0,0,0,0
60TGA,2018 Winter Olympics,60,TGA,Tonga,0,0,0,0,0
59TGA,2016 Summer Olympics,59,TGA,Tonga,6,0,0,0,0
58TGA,2014 Winter Olympics,58,TGA,Tonga,1,0,0,0,0
54TGA,2012 Summer Olympics,54,TGA,Tonga,2,0,0,0,0
53TGA,2008 Summer Olympics,53,TGA,Tonga,2,0,0,0,0
26TGA,2004 Summer Olympics,26,TGA,Tonga,5,0,0,0,0
25TGA,2000 Summer Olympics,25,TGA,Tonga,1,0,0,0,0
24TGA,1996 Summer Olympics,24,TGA,Tonga,4,0,1,0,1
23TGA,1992 Summer Olympics,23,TGA,Tonga,5,0,0,0,0
22TGA,1988 Summer Olympics,22,TGA,Tonga,5,0,0,0,0
21TGA,1984 Summer Olympics,21,TGA,Tonga,7,0,0,0,0
61TOG,2020 Summer Olympics,61,TOG,Togo,2,0,0,0,0
60TOG,2018 Winter Olympics,60,TOG,Togo,0,0,0,0,0
59TOG,2016 Summer Olympics,59,TOG,Togo,4,0,0,0,0
58TOG,2014 Winter Olympics,58,TOG,Togo,2,0,0,0,0
54TOG,2012 Summer Olympics,54,TOG,Togo,4,0,0,0,0
53TOG,2008 Summer Olympics,53,TOG,Togo,1,0,0,1,1
26TOG,2004 Summer Olympics,26,TOG,Togo,3,0,0,0,0
25TOG,2000 Summer Olympics,25,TOG,Togo,2,0,0,0,0
24TOG,1996 Summer Olympics,24,TOG,Togo,2,0,0,0,0
23TOG,1992 Summer Olympics,23,TOG,Togo,5,0,0,0,0
22TOG,1988 Summer Olympics,22,TOG,Togo,6,0,0,0,0
21TOG,1984 Summer Olympics,21,TOG,Togo,6,0,0,0,0
18TOG,1972 Summer Olympics,18,TOG,Togo,8,0,0,0,0
62SLO,2022 Winter Olympics,62,SLO,Slovenia,17,5,6,2,13
61SLO,2020 Summer Olympics,61,SLO,Slovenia,32,3,1,1,5
60SLO,2018 Winter Olympics,60,SLO,Slovenia,32,0,1,1,2
59SLO,2016 Summer Olympics,59,SLO,Slovenia,36,1,2,1,4
58SLO,2014 Winter Olympics,58,SLO,Slovenia,39,2,2,4,8
54SLO,2012 Summer Olympics,54,SLO,Slovenia,35,1,1,3,5
57SLO,2010 Winter Olympics,57,SLO,Slovenia,23,0,2,1,3
53SLO,2008 Summer Olympics,53,SLO,Slovenia,32,1,2,2,5
49SLO,2006 Winter Olympics,49,SLO,Slovenia,22,0,0,0,0
26SLO,2004 Summer Olympics,26,SLO,Slovenia,41,0,2,3,5
47SLO,2002 Winter Olympics,47,SLO,Slovenia,18,0,0,4,4
25SLO,2000 Summer Olympics,25,SLO,Slovenia,55,3,0,0,3
46SLO,1998 Winter Olympics,46,SLO,Slovenia,21,0,0,0,0
24SLO,1996 Summer Olympics,24,SLO,Slovenia,26,0,2,0,2
45SLO,1994 Winter Olympics,45,SLO,Slovenia,9,0,0,3,3
44SLO,1992 Winter Olympics,44,SLO,Slovenia,28,0,0,0,0
23SLO,1992 Summer Olympics,23,SLO,Slovenia,35,0,0,6,6
61GAM,2020 Summer Olympics,61,GAM,The Gambia,2,0,0,0,0
59GAM,2016 Summer Olympics,59,GAM,The Gambia,4,0,0,0,0
54GAM,2012 Summer Olympics,54,GAM,The Gambia,1,0,0,0,0
53GAM,2008 Summer Olympics,53,GAM,The Gambia,3,0,0,0,0
26GAM,2004 Summer Olympics,26,GAM,The Gambia,1,0,0,0,0
25GAM,2000 Summer Olympics,25,GAM,The Gambia,0,0,0,0,0
24GAM,1996 Summer Olympics,24,GAM,The Gambia,7,0,0,0,0
23GAM,1992 Summer Olympics,23,GAM,The Gambia,3,0,0,0,0
22GAM,1988 Summer Olympics,22,GAM,The Gambia,4,0,0,0,0
21GAM,1984 Summer Olympics,21,GAM,The Gambia,10,0,0,0,0
62TLS,2022 Winter Olympics,62,TLS,Timor-Leste,0,0,0,0,0
61TLS,2020 Summer Olympics,61,TLS,Timor-Leste,3,0,0,0,0
60TLS,2018 Winter Olympics,60,TLS,Timor-Leste,0,0,0,0,0
59TLS,2016 Summer Olympics,59,TLS,Timor-Leste,2,0,0,0,0
58TLS,2014 Winter Olympics,58,TLS,Timor-Leste,1,0,0,0,0
54TLS,2012 Summer Olympics,54,TLS,Timor-Leste,1,0,0,0,0
53TLS,2008 Summer Olympics,53,TLS,Timor-Leste,2,0,0,0,0
26TLS,2004 Summer Olympics,26,TLS,Timor-Leste,1,0,0,0,0
62SVK,2022 Winter Olympics,62,SVK,Slovakia,29,1,0,25,26
61SVK,2020 Summer Olympics,61,SVK,Slovakia,23,1,2,4,7
60SVK,2018 Winter Olympics,60,SVK,Slovakia,31,1,2,0,3
59SVK,2016 Summer Olympics,59,SVK,Slovakia,27,3,5,0,8
58SVK,2014 Winter Olympics,58,SVK,Slovakia,36,1,0,0,1
54SVK,2012 Summer Olympics,54,SVK,Slovakia,23,0,1,4,5
57SVK,2010 Winter Olympics,57,SVK,Slovakia,36,1,1,1,3
53SVK,2008 Summer Olympics,53,SVK,Slovakia,25,4,6,0,10
49SVK,2006 Winter Olympics,49,SVK,Slovakia,31,0,1,0,1
26SVK,2004 Summer Olympics,26,SVK,Slovakia,31,3,2,5,10
47SVK,2002 Winter Olympics,47,SVK,Slovakia,34,0,0,0,0
25SVK,2000 Summer Olympics,25,SVK,Slovakia,79,2,3,1,6
46SVK,1998 Winter Olympics,46,SVK,Slovakia,22,0,0,0,0
24SVK,1996 Summer Olympics,24,SVK,Slovakia,54,1,1,1,3
45SVK,1994 Winter Olympics,45,SVK,Slovakia,32,0,0,0,0
62GER,2022 Winter Olympics,62,GER,Germany,70,22,26,12,60
61GER,2020 Summer Olympics,61,GER,Germany,257,20,25,34,79
60GER,2018 Winter Olympics,60,GER,Germany,89,27,40,11,78
59GER,2016 Summer Olympics,59,GER,Germany,275,53,48,71,172
58GER,2014 Winter Olympics,58,GER,Germany,79,15,12,9,36
54GER,2012 Summer Olympics,54,GER,Germany,223,47,28,21,96
57GER,2010 Winter Olympics,57,GER,Germany,91,15,24,15,54
53GER,2008 Summer Olympics,53,GER,Germany,261,43,17,42,102
49GER,2006 Winter Olympics,49,GER,Germany,72,23,25,6,54
26GER,2004 Summer Olympics,26,GER,Germany,265,41,45,69,155
47GER,2002 Winter Olympics,47,GER,Germany,97,26,23,12,61
25GER,2000 Summer Olympics,25,GER,Germany,250,31,23,69,123
46GER,1998 Winter Olympics,46,GER,Germany,73,22,12,10,44
24GER,1996 Summer Olympics,24,GER,Germany,275,42,35,47,124
45GER,1994 Winter Olympics,45,GER,Germany,44,18,10,12,40
44GER,1992 Winter Olympics,44,GER,Germany,104,14,17,7,38
23GER,1992 Summer Olympics,23,GER,Germany,400,81,57,61,199
37GER,1964 Winter Olympics,37,GER,Germany,76,3,4,3,10
16GER,1964 Summer Olympics,16,GER,Germany,223,22,44,52,118
36GER,1960 Winter Olympics,36,GER,Germany,52,4,4,1,9
15GER,1960 Summer Olympics,15,GER,Germany,247,36,37,24,97
48GER,1956 Equestrian Olympics,48,GER,Germany,6,4,7,1,12
35GER,1956 Winter Olympics,35,GER,Germany,48,1,0,1,2
14GER,1956 Summer Olympics,14,GER,Germany,124,5,13,27,45
34GER,1952 Winter Olympics,34,GER,Germany,52,8,2,2,12
13GER,1952 Summer Olympics,13,GER,Germany,223,0,18,30,48
32GER,1936 Winter Olympics,32,GER,Germany,167,4,3,0,7
11GER,1936 Summer Olympics,11,GER,Germany,419,97,70,73,240
31GER,1932 Winter Olympics,31,GER,Germany,17,0,0,14,14
10GER,1932 Summer Olympics,10,GER,Germany,94,10,33,7,50
30GER,1928 Winter Olympics,30,GER,Germany,48,0,0,5,5
9GER,1928 Summer Olympics,9,GER,Germany,316,24,21,48,93
6GER,1912 Summer Olympics,6,GER,Germany,171,11,19,23,53
5GER,1908 Summer Olympics,5,GER,Germany,105,4,11,6,21
3GER,1904 Summer Olympics,3,GER,Germany,18,5,4,5,14
2GER,1900 Summer Olympics,2,GER,Germany,88,15,20,11,46
1GER,1896 Summer Olympics,1,GER,Germany,20,26,5,2,33
61SYR,2020 Summer Olympics,61,SYR,Syrian Arab Republic,3,0,0,1,1
59SYR,2016 Summer Olympics,59,SYR,Syrian Arab Republic,3,0,0,0,0
54SYR,2012 Summer Olympics,54,SYR,Syrian Arab Republic,6,0,0,0,0
53SYR,2008 Summer Olympics,53,SYR,Syrian Arab Republic,7,0,0,0,0
26SYR,2004 Summer Olympics,26,SYR,Syrian Arab Republic,6,0,0,1,1
25SYR,2000 Summer Olympics,25,SYR,Syrian Arab Republic,6,0,0,0,0
24SYR,1996 Summer Olympics,24,SYR,Syrian Arab Republic,3,1,0,0,1
23SYR,1992 Summer Olympics,23,SYR,Syrian Arab Republic,8,0,0,0,0
22SYR,1988 Summer Olympics,22,SYR,Syrian Arab Republic,12,0,0,0,0
21SYR,1984 Summer Olympics,21,SYR,Syrian Arab Republic,5,0,1,0,1
20SYR,1980 Summer Olympics,20,SYR,Syrian Arab Republic,69,0,0,0,0
18SYR,1972 Summer Olympics,18,SYR,Syrian Arab Republic,5,0,0,0,0
17SYR,1968 Summer Olympics,17,SYR,Syrian Arab Republic,2,0,0,0,0
12SYR,1948 Summer Olympics,12,SYR,Syrian Arab Republic,1,0,0,0,0
61SRI,2020 Summer Olympics,61,SRI,Sri Lanka,6,0,0,0,0
59SRI,2016 Summer Olympics,59,SRI,Sri Lanka,6,0,0,0,0
54SRI,2012 Summer Olympics,54,SRI,Sri Lanka,5,0,0,0,0
53SRI,2008 Summer Olympics,53,SRI,Sri Lanka,8,0,0,0,0
26SRI,2004 Summer Olympics,26,SRI,Sri Lanka,3,0,0,0,0
25SRI,2000 Summer Olympics,25,SRI,Sri Lanka,12,0,1,0,1
24SRI,1996 Summer Olympics,24,SRI,Sri Lanka,7,0,0,0,0
23SRI,1992 Summer Olympics,23,SRI,Sri Lanka,10,0,0,0,0
22SRI,1988 Summer Olympics,22,SRI,Sri Lanka,4,0,0,0,0
21SRI,1984 Summer Olympics,21,SRI,Sri Lanka,4,0,0,0,0
20SRI,1980 Summer Olympics,20,SRI,Sri Lanka,5,0,0,0,0
18SRI,1972 Summer Olympics,18,SRI,Sri Lanka,4,0,0,0,0
17SRI,1968 Summer Olympics,17,SRI,Sri Lanka,3,0,0,0,0
16SRI,1964 Summer Olympics,16,SRI,Sri Lanka,6,0,0,0,0
15SRI,1960 Summer Olympics,15,SRI,Sri Lanka,5,0,0,0,0
14SRI,1956 Summer Olympics,14,SRI,Sri Lanka,1,0,0,0,0
13SRI,1952 Summer Olympics,13,SRI,Sri Lanka,5,0,0,0,0
12SRI,1948 Summer Olympics,12,SRI,Sri Lanka,7,0,1,0,1
61TJK,2020 Summer Olympics,61,TJK,Tajikistan,7,0,0,0,0
59TJK,2016 Summer Olympics,59,TJK,Tajikistan,5,1,0,0,1
58TJK,2014 Winter Olympics,58,TJK,Tajikistan,1,0,0,0,0
54TJK,2012 Summer Olympics,54,TJK,Tajikistan,9,0,0,1,1
57TJK,2010 Winter Olympics,57,TJK,Tajikistan,0,0,0,0,0
53TJK,2008 Summer Olympics,53,TJK,Tajikistan,10,0,1,1,2
49TJK,2006 Winter Olympics,49,TJK,Tajikistan,0,0,0,0,0
26TJK,2004 Summer Olympics,26,TJK,Tajikistan,8,0,0,0,0
47TJK,2002 Winter Olympics,47,TJK,Tajikistan,1,0,0,0,0
25TJK,2000 Summer Olympics,25,TJK,Tajikistan,3,0,0,0,0
24TJK,1996 Summer Olympics,24,TJK,Tajikistan,8,0,0,0,0
61SUD,2020 Summer Olympics,61,SUD,Sudan,4,0,0,0,0
59SUD,2016 Summer Olympics,59,SUD,Sudan,5,0,0,0,0
54SUD,2012 Summer Olympics,54,SUD,Sudan,4,0,0,0,0
53SUD,2008 Summer Olympics,53,SUD,Sudan,6,0,1,0,1
26SUD,2004 Summer Olympics,26,SUD,Sudan,4,0,0,0,0
25SUD,2000 Summer Olympics,25,SUD,Sudan,2,0,0,0,0
24SUD,1996 Summer Olympics,24,SUD,Sudan,3,0,0,0,0
23SUD,1992 Summer Olympics,23,SUD,Sudan,6,0,0,0,0
22SUD,1988 Summer Olympics,22,SUD,Sudan,5,0,0,0,0
21SUD,1984 Summer Olympics,21,SUD,Sudan,7,0,0,0,0
18SUD,1972 Summer Olympics,18,SUD,Sudan,30,0,0,0,0
17SUD,1968 Summer Olympics,17,SUD,Sudan,4,0,0,0,0
15SUD,1960 Summer Olympics,15,SUD,Sudan,10,0,0,0,0
61SUR,2020 Summer Olympics,61,SUR,Suriname,1,0,0,0,0
59SUR,2016 Summer Olympics,59,SUR,Suriname,5,0,0,0,0
54SUR,2012 Summer Olympics,54,SUR,Suriname,2,0,0,0,0
53SUR,2008 Summer Olympics,53,SUR,Suriname,3,0,0,0,0
26SUR,2004 Summer Olympics,26,SUR,Suriname,3,0,0,0,0
25SUR,2000 Summer Olympics,25,SUR,Suriname,1,0,0,0,0
24SUR,1996 Summer Olympics,24,SUR,Suriname,3,0,0,0,0
23SUR,1992 Summer Olympics,23,SUR,Suriname,2,0,0,1,1
22SUR,1988 Summer Olympics,22,SUR,Suriname,4,1,0,0,1
21SUR,1984 Summer Olympics,21,SUR,Suriname,5,0,0,0,0
19SUR,1976 Summer Olympics,19,SUR,Suriname,2,0,0,0,0
18SUR,1972 Summer Olympics,18,SUR,Suriname,2,0,0,0,0
17SUR,1968 Summer Olympics,17,SUR,Suriname,1,0,0,0,0
61SGP,2020 Summer Olympics,61,SGP,Singapore,17,0,0,0,0
60SGP,2018 Winter Olympics,60,SGP,Singapore,1,0,0,0,0
59SGP,2016 Summer Olympics,59,SGP,Singapore,16,1,0,0,1
54SGP,2012 Summer Olympics,54,SGP,Singapore,16,0,0,4,4
53SGP,2008 Summer Olympics,53,SGP,Singapore,22,0,3,0,3
26SGP,2004 Summer Olympics,26,SGP,Singapore,7,0,0,0,0
25SGP,2000 Summer Olympics,25,SGP,Singapore,11,0,0,0,0
24SGP,1996 Summer Olympics,24,SGP,Singapore,10,0,0,0,0
23SGP,1992 Summer Olympics,23,SGP,Singapore,11,0,0,0,0
22SGP,1988 Summer Olympics,22,SGP,Singapore,6,0,0,0,0
21SGP,1984 Summer Olympics,21,SGP,Singapore,5,0,0,0,0
19SGP,1976 Summer Olympics,19,SGP,Singapore,4,0,0,0,0
18SGP,1972 Summer Olympics,18,SGP,Singapore,6,0,0,0,0
17SGP,1968 Summer Olympics,17,SGP,Singapore,3,0,0,0,0
15SGP,1960 Summer Olympics,15,SGP,Singapore,2,0,1,0,1
14SGP,1956 Summer Olympics,14,SGP,Singapore,50,0,0,0,0
13SGP,1952 Summer Olympics,13,SGP,Singapore,5,0,0,0,0
12SGP,1948 Summer Olympics,12,SGP,Singapore,1,0,0,0,0
62NZL,2022 Winter Olympics,62,NZL,New Zealand,9,2,1,0,3
61NZL,2020 Summer Olympics,61,NZL,New Zealand,130,29,28,8,65
60NZL,2018 Winter Olympics,60,NZL,New Zealand,15,0,0,2,2
59NZL,2016 Summer Olympics,59,NZL,New Zealand,127,6,25,5,36
58NZL,2014 Winter Olympics,58,NZL,New Zealand,12,0,0,0,0
54NZL,2012 Summer Olympics,54,NZL,New Zealand,116,9,3,15,27
57NZL,2010 Winter Olympics,57,NZL,New Zealand,12,0,0,0,0
53NZL,2008 Summer Olympics,53,NZL,New Zealand,124,4,2,9,15
49NZL,2006 Winter Olympics,49,NZL,New Zealand,15,0,0,0,0
26NZL,2004 Summer Olympics,26,NZL,New Zealand,103,4,2,0,6
47NZL,2002 Winter Olympics,47,NZL,New Zealand,6,0,0,0,0
25NZL,2000 Summer Olympics,25,NZL,New Zealand,111,1,0,3,4
46NZL,1998 Winter Olympics,46,NZL,New Zealand,5,0,0,0,0
24NZL,1996 Summer Olympics,24,NZL,New Zealand,62,3,2,4,9
45NZL,1994 Winter Olympics,45,NZL,New Zealand,1,0,0,0,0
44NZL,1992 Winter Olympics,44,NZL,New Zealand,10,0,1,0,1
23NZL,1992 Summer Olympics,23,NZL,New Zealand,98,1,9,5,15
43NZL,1988 Winter Olympics,43,NZL,New Zealand,5,0,0,0,0
22NZL,1988 Summer Olympics,22,NZL,New Zealand,59,4,4,16,24
42NZL,1984 Winter Olympics,42,NZL,New Zealand,6,0,0,0,0
21NZL,1984 Summer Olympics,21,NZL,New Zealand,118,16,1,6,23
41NZL,1980 Winter Olympics,41,NZL,New Zealand,4,0,0,0,0
20NZL,1980 Summer Olympics,20,NZL,New Zealand,4,0,0,0,0
40NZL,1976 Winter Olympics,40,NZL,New Zealand,5,0,0,0,0
19NZL,1976 Summer Olympics,19,NZL,New Zealand,51,17,1,9,27
39NZL,1972 Winter Olympics,39,NZL,New Zealand,2,0,0,0,0
18NZL,1972 Summer Olympics,18,NZL,New Zealand,65,9,4,1,14
38NZL,1968 Winter Olympics,38,NZL,New Zealand,6,0,0,0,0
17NZL,1968 Summer Olympics,17,NZL,New Zealand,40,5,0,2,7
16NZL,1964 Summer Olympics,16,NZL,New Zealand,51,4,0,2,6
36NZL,1960 Winter Olympics,36,NZL,New Zealand,3,0,0,0,0
15NZL,1960 Summer Olympics,15,NZL,New Zealand,25,2,0,1,3
14NZL,1956 Summer Olympics,14,NZL,New Zealand,48,3,0,0,3
34NZL,1952 Winter Olympics,34,NZL,New Zealand,3,0,0,0,0
13NZL,1952 Summer Olympics,13,NZL,New Zealand,13,1,0,2,3
12NZL,1948 Summer Olympics,12,NZL,New Zealand,7,0,0,0,0
11NZL,1936 Summer Olympics,11,NZL,New Zealand,6,1,0,0,1
10NZL,1932 Summer Olympics,10,NZL,New Zealand,21,0,2,0,2
9NZL,1928 Summer Olympics,9,NZL,New Zealand,9,1,0,0,1
8NZL,1924 Summer Olympics,8,NZL,New Zealand,4,0,0,1,1
7NZL,1920 Summer Olympics,7,NZL,New Zealand,4,0,0,1,1
18VNM,1972 Summer Olympics,18,VNM,South Vietnam,1,0,0,0,0
17VNM,1968 Summer Olympics,17,VNM,South Vietnam,9,0,0,0,0
16VNM,1964 Summer Olympics,16,VNM,South Vietnam,13,0,0,0,0
15VNM,1960 Summer Olympics,15,VNM,South Vietnam,4,0,0,0,0
14VNM,1956 Summer Olympics,14,VNM,South Vietnam,5,0,0,0,0
13VNM,1952 Summer Olympics,13,VNM,South Vietnam,9,0,0,0,0
61SOM,2020 Summer Olympics,61,SOM,Somalia,2,0,0,0,0
59SOM,2016 Summer Olympics,59,SOM,Somalia,2,0,0,0,0
54SOM,2012 Summer Olympics,54,SOM,Somalia,2,0,0,0,0
53SOM,2008 Summer Olympics,53,SOM,Somalia,2,0,0,0,0
26SOM,2004 Summer Olympics,26,SOM,Somalia,2,0,0,0,0
25SOM,2000 Summer Olympics,25,SOM,Somalia,1,0,0,0,0
24SOM,1996 Summer Olympics,24,SOM,Somalia,2,0,0,0,0
22SOM,1988 Summer Olympics,22,SOM,Somalia,1,0,0,0,0
21SOM,1984 Summer Olympics,21,SOM,Somalia,7,0,0,0,0
18SOM,1972 Summer Olympics,18,SOM,Somalia,4,0,0,0,0
61SOL,2020 Summer Olympics,61,SOL,Solomon Islands,2,0,0,0,0
59SOL,2016 Summer Olympics,59,SOL,Solomon Islands,2,0,0,0,0
54SOL,2012 Summer Olympics,54,SOL,Solomon Islands,3,0,0,0,0
53SOL,2008 Summer Olympics,53,SOL,Solomon Islands,2,0,0,0,0
26SOL,2004 Summer Olympics,26,SOL,Solomon Islands,1,0,0,0,0
25SOL,2000 Summer Olympics,25,SOL,Solomon Islands,1,0,0,0,0
24SOL,1996 Summer Olympics,24,SOL,Solomon Islands,4,0,0,0,0
23SOL,1992 Summer Olympics,23,SOL,Solomon Islands,0,0,0,0,0
22SOL,1988 Summer Olympics,22,SOL,Solomon Islands,5,0,0,0,0
21SOL,1984 Summer Olympics,21,SOL,Solomon Islands,3,0,0,0,0
62POR,2022 Winter Olympics,62,POR,Portugal,3,0,0,0,0
61POR,2020 Summer Olympics,61,POR,Portugal,54,1,1,2,4
60POR,2018 Winter Olympics,60,POR,Portugal,1,0,0,0,0
59POR,2016 Summer Olympics,59,POR,Portugal,58,0,0,1,1
58POR,2014 Winter Olympics,58,POR,Portugal,2,0,0,0,0
54POR,2012 Summer Olympics,54,POR,Portugal,33,0,2,0,2
57POR,2010 Winter Olympics,57,POR,Portugal,0,0,0,0,0
53POR,2008 Summer Olympics,53,POR,Portugal,47,1,1,0,2
49POR,2006 Winter Olympics,49,POR,Portugal,1,0,0,0,0
26POR,2004 Summer Olympics,26,POR,Portugal,52,0,2,1,3
25POR,2000 Summer Olympics,25,POR,Portugal,30,0,0,2,2
46POR,1998 Winter Olympics,46,POR,Portugal,2,0,0,0,0
24POR,1996 Summer Olympics,24,POR,Portugal,77,1,0,2,3
45POR,1994 Winter Olympics,45,POR,Portugal,1,0,0,0,0
23POR,1992 Summer Olympics,23,POR,Portugal,71,0,0,0,0
43POR,1988 Winter Olympics,43,POR,Portugal,5,0,0,0,0
22POR,1988 Summer Olympics,22,POR,Portugal,51,1,0,0,1
21POR,1984 Summer Olympics,21,POR,Portugal,31,1,0,2,3
20POR,1980 Summer Olympics,20,POR,Portugal,6,0,0,0,0
19POR,1976 Summer Olympics,19,POR,Portugal,12,0,2,0,2
18POR,1972 Summer Olympics,18,POR,Portugal,19,0,0,0,0
17POR,1968 Summer Olympics,17,POR,Portugal,15,0,0,0,0
16POR,1964 Summer Olympics,16,POR,Portugal,9,0,0,0,0
15POR,1960 Summer Olympics,15,POR,Portugal,51,0,2,0,2
48POR,1956 Equestrian Olympics,48,POR,Portugal,3,0,0,0,0
14POR,1956 Summer Olympics,14,POR,Portugal,3,0,0,0,0
34POR,1952 Winter Olympics,34,POR,Portugal,1,0,0,0,0
13POR,1952 Summer Olympics,13,POR,Portugal,63,0,0,2,2
12POR,1948 Summer Olympics,12,POR,Portugal,43,0,2,3,5
11POR,1936 Summer Olympics,11,POR,Portugal,13,0,0,3,3
10POR,1932 Summer Olympics,10,POR,Portugal,3,0,0,0,0
9POR,1928 Summer Olympics,9,POR,Portugal,34,0,0,6,6
8POR,1924 Summer Olympics,8,POR,Portugal,20,0,0,4,4
7POR,1920 Summer Olympics,7,POR,Portugal,12,0,0,0,0
6POR,1912 Summer Olympics,6,POR,Portugal,8,0,0,0,0
61SEN,2020 Summer Olympics,61,SEN,Senegal,7,0,0,0,0
59SEN,2016 Summer Olympics,59,SEN,Senegal,17,0,0,0,0
54SEN,2012 Summer Olympics,54,SEN,Senegal,31,0,0,0,0
57SEN,2010 Winter Olympics,57,SEN,Senegal,0,0,0,0,0
53SEN,2008 Summer Olympics,53,SEN,Senegal,10,0,0,0,0
49SEN,2006 Winter Olympics,49,SEN,Senegal,1,0,0,0,0
26SEN,2004 Summer Olympics,26,SEN,Senegal,10,0,0,0,0
25SEN,2000 Summer Olympics,25,SEN,Senegal,23,0,0,0,0
24SEN,1996 Summer Olympics,24,SEN,Senegal,7,0,0,0,0
45SEN,1994 Winter Olympics,45,SEN,Senegal,0,0,0,0,0
44SEN,1992 Winter Olympics,44,SEN,Senegal,1,0,0,0,0
23SEN,1992 Summer Olympics,23,SEN,Senegal,10,0,0,0,0
22SEN,1988 Summer Olympics,22,SEN,Senegal,16,0,1,0,1
42SEN,1984 Winter Olympics,42,SEN,Senegal,1,0,0,0,0
21SEN,1984 Summer Olympics,21,SEN,Senegal,20,0,0,0,0
20SEN,1980 Summer Olympics,20,SEN,Senegal,26,0,0,0,0
19SEN,1976 Summer Olympics,19,SEN,Senegal,14,0,0,0,0
18SEN,1972 Summer Olympics,18,SEN,Senegal,30,0,0,0,0
17SEN,1968 Summer Olympics,17,SEN,Senegal,17,0,0,0,0
16SEN,1964 Summer Olympics,16,SEN,Senegal,12,0,0,0,0
22YMD,1988 Summer Olympics,22,YMD,South Yemen,5,0,0,0,0
62SMR,2022 Winter Olympics,62,SMR,San Marino,2,0,0,0,0
61SMR,2020 Summer Olympics,61,SMR,San Marino,4,0,2,2,4
60SMR,2018 Winter Olympics,60,SMR,San Marino,1,0,0,0,0
59SMR,2016 Summer Olympics,59,SMR,San Marino,3,0,0,0,0
58SMR,2014 Winter Olympics,58,SMR,San Marino,2,0,0,0,0
54SMR,2012 Summer Olympics,54,SMR,San Marino,4,0,0,0,0
57SMR,2010 Winter Olympics,57,SMR,San Marino,0,0,0,0,0
53SMR,2008 Summer Olympics,53,SMR,San Marino,3,0,0,0,0
49SMR,2006 Winter Olympics,49,SMR,San Marino,1,0,0,0,0
26SMR,2004 Summer Olympics,26,SMR,San Marino,2,0,0,0,0
47SMR,2002 Winter Olympics,47,SMR,San Marino,1,0,0,0,0
25SMR,2000 Summer Olympics,25,SMR,San Marino,1,0,0,0,0
24SMR,1996 Summer Olympics,24,SMR,San Marino,4,0,0,0,0
45SMR,1994 Winter Olympics,45,SMR,San Marino,2,0,0,0,0
44SMR,1992 Winter Olympics,44,SMR,San Marino,1,0,0,0,0
23SMR,1992 Summer Olympics,23,SMR,San Marino,13,0,0,0,0
43SMR,1988 Winter Olympics,43,SMR,San Marino,3,0,0,0,0
22SMR,1988 Summer Olympics,22,SMR,San Marino,7,0,0,0,0
42SMR,1984 Winter Olympics,42,SMR,San Marino,3,0,0,0,0
21SMR,1984 Summer Olympics,21,SMR,San Marino,7,0,0,0,0
20SMR,1980 Summer Olympics,20,SMR,San Marino,11,0,0,0,0
40SMR,1976 Winter Olympics,40,SMR,San Marino,2,0,0,0,0
19SMR,1976 Summer Olympics,19,SMR,San Marino,4,0,0,0,0
18SMR,1972 Summer Olympics,18,SMR,San Marino,6,0,0,0,0
17SMR,1968 Summer Olympics,17,SMR,San Marino,3,0,0,0,0
15SMR,1960 Summer Olympics,15,SMR,San Marino,9,0,0,0,0
62SRB,2022 Winter Olympics,62,SRB,Serbia,0,0,0,0,0
61SRB,2020 Summer Olympics,61,SRB,Serbia,42,15,1,19,35
60SRB,2018 Winter Olympics,60,SRB,Serbia,2,0,0,0,0
59SRB,2016 Summer Olympics,59,SRB,Serbia,55,14,27,13,54
58SRB,2014 Winter Olympics,58,SRB,Serbia,5,0,0,0,0
54SRB,2012 Summer Olympics,54,SRB,Serbia,67,1,1,14,16
57SRB,2010 Winter Olympics,57,SRB,Serbia,7,0,0,0,0
53SRB,2008 Summer Olympics,53,SRB,Serbia,63,0,1,14,15
6SRB,1912 Summer Olympics,6,SRB,Serbia,3,0,0,0,0
61SSD,2020 Summer Olympics,61,SSD,South Sudan,2,0,0,0,0
59SSD,2016 Summer Olympics,59,SSD,South Sudan,2,0,0,0,0
61SLE,2020 Summer Olympics,61,SLE,Sierra Leone,4,0,0,0,0
59SLE,2016 Summer Olympics,59,SLE,Sierra Leone,4,0,0,0,0
54SLE,2012 Summer Olympics,54,SLE,Sierra Leone,2,0,0,0,0
53SLE,2008 Summer Olympics,53,SLE,Sierra Leone,3,0,0,0,0
26SLE,2004 Summer Olympics,26,SLE,Sierra Leone,2,0,0,0,0
25SLE,2000 Summer Olympics,25,SLE,Sierra Leone,3,0,0,0,0
24SLE,1996 Summer Olympics,24,SLE,Sierra Leone,8,0,0,0,0
23SLE,1992 Summer Olympics,23,SLE,Sierra Leone,8,0,0,0,0
22SLE,1988 Summer Olympics,22,SLE,Sierra Leone,9,0,0,0,0
21SLE,1984 Summer Olympics,21,SLE,Sierra Leone,8,0,0,0,0
20SLE,1980 Summer Olympics,20,SLE,Sierra Leone,14,0,0,0,0
17SLE,1968 Summer Olympics,17,SLE,Sierra Leone,2,0,0,0,0
62HUN,2022 Winter Olympics,62,HUN,Hungary,8,1,0,6,7
61HUN,2020 Summer Olympics,61,HUN,Hungary,103,9,7,35,51
60HUN,2018 Winter Olympics,60,HUN,Hungary,11,5,0,0,5
59HUN,2016 Summer Olympics,59,HUN,Hungary,71,12,3,7,22
58HUN,2014 Winter Olympics,58,HUN,Hungary,10,0,0,0,0
54HUN,2012 Summer Olympics,54,HUN,Hungary,75,12,8,6,26
57HUN,2010 Winter Olympics,57,HUN,Hungary,7,0,0,0,0
53HUN,2008 Summer Olympics,53,HUN,Hungary,79,16,8,3,27
49HUN,2006 Winter Olympics,49,HUN,Hungary,10,0,0,0,0
26HUN,2004 Summer Olympics,26,HUN,Hungary,125,24,12,4,40
47HUN,2002 Winter Olympics,47,HUN,Hungary,17,0,0,0,0
25HUN,2000 Summer Olympics,25,HUN,Hungary,102,25,24,4,53
46HUN,1998 Winter Olympics,46,HUN,Hungary,12,0,0,0,0
24HUN,1996 Summer Olympics,24,HUN,Hungary,135,8,9,26,43
45HUN,1994 Winter Olympics,45,HUN,Hungary,9,0,0,0,0
44HUN,1992 Winter Olympics,44,HUN,Hungary,21,0,0,0,0
23HUN,1992 Summer Olympics,23,HUN,Hungary,137,14,23,8,45
43HUN,1988 Winter Olympics,43,HUN,Hungary,1,0,0,0,0
22HUN,1988 Summer Olympics,22,HUN,Hungary,168,20,9,15,44
42HUN,1984 Winter Olympics,42,HUN,Hungary,8,0,0,0,0
41HUN,1980 Winter Olympics,41,HUN,Hungary,0,0,2,0,2
20HUN,1980 Summer Olympics,20,HUN,Hungary,177,8,13,40,61
40HUN,1976 Winter Olympics,40,HUN,Hungary,3,0,0,0,0
19HUN,1976 Summer Olympics,19,HUN,Hungary,116,14,6,35,55
39HUN,1972 Winter Olympics,39,HUN,Hungary,0,0,0,0,0
18HUN,1972 Summer Olympics,18,HUN,Hungary,165,10,48,25,83
38HUN,1968 Winter Olympics,38,HUN,Hungary,6,0,0,0,0
17HUN,1968 Summer Olympics,17,HUN,Hungary,113,34,20,29,83
37HUN,1964 Winter Olympics,37,HUN,Hungary,27,0,0,0,0
16HUN,1964 Summer Olympics,16,HUN,Hungary,115,47,7,7,61
36HUN,1960 Winter Olympics,36,HUN,Hungary,2,0,0,0,0
15HUN,1960 Summer Olympics,15,HUN,Hungary,145,13,16,40,69
48HUN,1956 Equestrian Olympics,48,HUN,Hungary,2,0,0,0,0
35HUN,1956 Winter Olympics,35,HUN,Hungary,1,0,0,2,2
14HUN,1956 Summer Olympics,14,HUN,Hungary,58,31,20,14,65
34HUN,1952 Winter Olympics,34,HUN,Hungary,10,0,0,2,2
13HUN,1952 Summer Olympics,13,HUN,Hungary,129,59,17,34,110
33HUN,1948 Winter Olympics,33,HUN,Hungary,21,0,2,0,2
12HUN,1948 Summer Olympics,12,HUN,Hungary,129,15,27,22,64
32HUN,1936 Winter Olympics,32,HUN,Hungary,21,0,0,2,2
11HUN,1936 Summer Olympics,11,HUN,Hungary,234,25,1,17,43
31HUN,1932 Winter Olympics,31,HUN,Hungary,4,0,0,2,2
10HUN,1932 Summer Olympics,10,HUN,Hungary,36,21,5,8,34
30HUN,1928 Winter Olympics,30,HUN,Hungary,11,0,0,0,0
9HUN,1928 Summer Olympics,9,HUN,Hungary,95,10,15,0,25
29HUN,1924 Winter Olympics,29,HUN,Hungary,4,0,0,0,0
8HUN,1924 Summer Olympics,8,HUN,Hungary,123,2,11,9,22
6HUN,1912 Summer Olympics,6,HUN,Hungary,137,10,20,3,33
5HUN,1908 Summer Olympics,5,HUN,Hungary,127,7,7,6,20
3HUN,1904 Summer Olympics,3,HUN,Hungary,2,2,1,1,4
2HUN,1900 Summer Olympics,2,HUN,Hungary,37,1,2,2,5
1HUN,1896 Summer Olympics,1,HUN,Hungary,14,2,1,3,6
61SEY,2020 Summer Olympics,61,SEY,Seychelles,3,0,0,0,0
59SEY,2016 Summer Olympics,59,SEY,Seychelles,6,0,0,0,0
54SEY,2012 Summer Olympics,54,SEY,Seychelles,6,0,0,0,0
53SEY,2008 Summer Olympics,53,SEY,Seychelles,6,0,0,0,0
26SEY,2004 Summer Olympics,26,SEY,Seychelles,7,0,0,0,0
25SEY,2000 Summer Olympics,25,SEY,Seychelles,6,0,0,0,0
24SEY,1996 Summer Olympics,24,SEY,Seychelles,5,0,0,0,0
23SEY,1992 Summer Olympics,23,SEY,Seychelles,11,0,0,0,0
21SEY,1984 Summer Olympics,21,SEY,Seychelles,6,0,0,0,0
20SEY,1980 Summer Olympics,20,SEY,Seychelles,11,0,0,0,0
49SCG,2006 Winter Olympics,49,SCG,Serbia and Montenegro,4,0,0,0,0
26SCG,2004 Summer Olympics,26,SCG,Serbia and Montenegro,53,0,14,0,14
47SCG,2002 Winter Olympics,47,SCG,Serbia and Montenegro,5,0,0,0,0
25SCG,2000 Summer Olympics,25,SCG,Serbia and Montenegro,74,12,1,13,26
46SCG,1998 Winter Olympics,46,SCG,Serbia and Montenegro,2,0,0,0,0
24SCG,1996 Summer Olympics,24,SCG,Serbia and Montenegro,51,1,12,13,26
62MEX,2022 Winter Olympics,62,MEX,Mexico,2,0,0,0,0
61MEX,2020 Summer Olympics,61,MEX,Mexico,129,0,0,27,27
60MEX,2018 Winter Olympics,60,MEX,Mexico,4,0,0,0,0
59MEX,2016 Summer Olympics,59,MEX,Mexico,95,0,3,2,5
58MEX,2014 Winter Olympics,58,MEX,Mexico,0,0,0,0,0
54MEX,2012 Summer Olympics,54,MEX,Mexico,75,22,5,4,31
57MEX,2010 Winter Olympics,57,MEX,Mexico,0,0,0,0,0
53MEX,2008 Summer Olympics,53,MEX,Mexico,61,2,0,3,5
26MEX,2004 Summer Olympics,26,MEX,Mexico,93,0,3,1,4
47MEX,2002 Winter Olympics,47,MEX,Mexico,2,0,0,0,0
25MEX,2000 Summer Olympics,25,MEX,Mexico,55,1,2,3,6
24MEX,1996 Summer Olympics,24,MEX,Mexico,85,0,0,1,1
45MEX,1994 Winter Olympics,45,MEX,Mexico,0,0,0,0,0
44MEX,1992 Winter Olympics,44,MEX,Mexico,13,0,0,0,0
23MEX,1992 Summer Olympics,23,MEX,Mexico,106,0,1,0,1
43MEX,1988 Winter Olympics,43,MEX,Mexico,10,0,0,0,0
22MEX,1988 Summer Olympics,22,MEX,Mexico,62,0,0,2,2
42MEX,1984 Winter Olympics,42,MEX,Mexico,1,0,0,0,0
21MEX,1984 Summer Olympics,21,MEX,Mexico,80,2,3,1,6
20MEX,1980 Summer Olympics,20,MEX,Mexico,30,0,1,9,10
19MEX,1976 Summer Olympics,19,MEX,Mexico,69,1,0,1,2
18MEX,1972 Summer Olympics,18,MEX,Mexico,118,0,1,0,1
17MEX,1968 Summer Olympics,17,MEX,Mexico,269,3,3,3,9
16MEX,1964 Summer Olympics,16,MEX,Mexico,82,0,0,1,1
15MEX,1960 Summer Olympics,15,MEX,Mexico,61,0,0,1,1
14MEX,1956 Summer Olympics,14,MEX,Mexico,14,1,0,1,2
13MEX,1952 Summer Olympics,13,MEX,Mexico,52,0,1,0,1
12MEX,1948 Summer Olympics,12,MEX,Mexico,94,4,1,4,9
11MEX,1936 Summer Olympics,11,MEX,Mexico,26,0,0,16,16
10MEX,1932 Summer Olympics,10,MEX,Mexico,71,0,2,0,2
30MEX,1928 Winter Olympics,30,MEX,Mexico,5,0,0,0,0
9MEX,1928 Summer Olympics,9,MEX,Mexico,34,0,0,0,0
8MEX,1924 Summer Olympics,8,MEX,Mexico,16,0,0,0,0
2MEX,1900 Summer Olympics,2,MEX,Mexico,21,0,0,4,4
62CAN,2022 Winter Olympics,62,CAN,Canada,119,33,8,28,69
61CAN,2020 Summer Olympics,61,CAN,Canada,234,36,18,31,85
60CAN,2018 Winter Olympics,60,CAN,Canada,119,30,33,40,103
59CAN,2016 Summer Olympics,59,CAN,Canada,216,4,4,65,73
58CAN,2014 Winter Olympics,58,CAN,Canada,126,63,23,5,91
54CAN,2012 Summer Olympics,54,CAN,Canada,172,2,22,35,59
57CAN,2010 Winter Olympics,57,CAN,Canada,109,69,16,8,93
53CAN,2008 Summer Olympics,53,CAN,Canada,241,11,13,12,36
49CAN,2006 Winter Olympics,49,CAN,Canada,132,30,28,11,69
26CAN,2004 Summer Olympics,26,CAN,Canada,174,3,10,4,17
47CAN,2002 Winter Olympics,47,CAN,Canada,81,53,7,15,75
25CAN,2000 Summer Olympics,25,CAN,Canada,204,4,4,23,31
46CAN,1998 Winter Olympics,46,CAN,Canada,111,15,28,8,51
24CAN,1996 Summer Olympics,24,CAN,Canada,205,8,30,12,50
45CAN,1994 Winter Olympics,45,CAN,Canada,55,3,32,5,40
44CAN,1992 Winter Olympics,44,CAN,Canada,92,6,29,3,38
23CAN,1992 Summer Olympics,23,CAN,Canada,193,27,5,12,44
43CAN,1988 Winter Olympics,43,CAN,Canada,113,0,2,4,6
22CAN,1988 Summer Olympics,22,CAN,Canada,244,4,5,14,23
42CAN,1984 Winter Olympics,42,CAN,Canada,52,2,1,1,4
21CAN,1984 Summer Olympics,21,CAN,Canada,395,19,36,35,90
41CAN,1980 Winter Olympics,41,CAN,Canada,43,0,1,1,2
40CAN,1976 Winter Olympics,40,CAN,Canada,42,1,1,1,3
19CAN,1976 Summer Olympics,19,CAN,Canada,329,0,9,14,23
39CAN,1972 Winter Olympics,39,CAN,Canada,41,0,1,0,1
18CAN,1972 Summer Olympics,18,CAN,Canada,170,0,2,11,13
38CAN,1968 Winter Olympics,38,CAN,Canada,55,1,1,18,20
17CAN,1968 Summer Olympics,17,CAN,Canada,108,3,3,4,10
37CAN,1964 Winter Olympics,37,CAN,Canada,51,4,2,1,7
16CAN,1964 Summer Olympics,16,CAN,Canada,104,2,2,1,5
36CAN,1960 Winter Olympics,36,CAN,Canada,33,3,17,1,21
15CAN,1960 Summer Olympics,15,CAN,Canada,64,0,9,0,9
48CAN,1956 Equestrian Olympics,48,CAN,Canada,4,0,0,3,3
35CAN,1956 Winter Olympics,35,CAN,Canada,28,0,2,18,20
14CAN,1956 Summer Olympics,14,CAN,Canada,77,5,9,2,16
34CAN,1952 Winter Olympics,34,CAN,Canada,34,16,0,1,17
13CAN,1952 Summer Olympics,13,CAN,Canada,100,1,3,0,4
33CAN,1948 Winter Olympics,33,CAN,Canada,32,18,0,2,20
12CAN,1948 Summer Olympics,12,CAN,Canada,124,0,2,8,10
32CAN,1936 Winter Olympics,32,CAN,Canada,24,0,15,0,15
11CAN,1936 Summer Olympics,11,CAN,Canada,89,1,17,11,29
31CAN,1932 Winter Olympics,31,CAN,Canada,118,14,1,5,20
10CAN,1932 Summer Olympics,10,CAN,Canada,102,2,15,27,44
30CAN,1928 Winter Olympics,30,CAN,Canada,21,13,0,0,13
9CAN,1928 Summer Olympics,9,CAN,Canada,80,8,6,26,40
29CAN,1924 Winter Olympics,29,CAN,Canada,13,10,0,0,10
8CAN,1924 Summer Olympics,8,CAN,Canada,65,0,21,1,22
7CAN,1920 Summer Olympics,7,CAN,Canada,53,10,3,3,16
6CAN,1912 Summer Olympics,6,CAN,Canada,27,3,2,3,8
5CAN,1908 Summer Olympics,5,CAN,Canada,91,17,8,32,57
3CAN,1904 Summer Olympics,3,CAN,Canada,64,28,10,12,50
62PUR,2022 Winter Olympics,62,PUR,Puerto Rico,2,0,0,0,0
61PUR,2020 Summer Olympics,61,PUR,Puerto Rico,25,1,0,0,1
60PUR,2018 Winter Olympics,60,PUR,Puerto Rico,1,0,0,0,0
59PUR,2016 Summer Olympics,59,PUR,Puerto Rico,31,1,0,0,1
54PUR,2012 Summer Olympics,54,PUR,Puerto Rico,21,0,1,1,2
53PUR,2008 Summer Olympics,53,PUR,Puerto Rico,20,0,0,0,0
26PUR,2004 Summer Olympics,26,PUR,Puerto Rico,32,0,0,0,0
25PUR,2000 Summer Olympics,25,PUR,Puerto Rico,22,0,0,0,0
46PUR,1998 Winter Olympics,46,PUR,Puerto Rico,2,0,0,0,0
24PUR,1996 Summer Olympics,24,PUR,Puerto Rico,54,0,0,1,1
45PUR,1994 Winter Olympics,45,PUR,Puerto Rico,1,0,0,0,0
44PUR,1992 Winter Olympics,44,PUR,Puerto Rico,4,0,0,0,0
23PUR,1992 Summer Olympics,23,PUR,Puerto Rico,48,0,0,1,1
43PUR,1988 Winter Olympics,43,PUR,Puerto Rico,9,0,0,0,0
22PUR,1988 Summer Olympics,22,PUR,Puerto Rico,64,0,0,0,0
42PUR,1984 Winter Olympics,42,PUR,Puerto Rico,1,0,0,0,0
21PUR,1984 Summer Olympics,21,PUR,Puerto Rico,49,0,1,1,2
20PUR,1980 Summer Olympics,20,PUR,Puerto Rico,3,0,0,0,0
19PUR,1976 Summer Olympics,19,PUR,Puerto Rico,59,0,0,1,1
18PUR,1972 Summer Olympics,18,PUR,Puerto Rico,38,0,0,0,0
17PUR,1968 Summer Olympics,17,PUR,Puerto Rico,47,0,0,0,0
16PUR,1964 Summer Olympics,16,PUR,Puerto Rico,22,0,0,0,0
15PUR,1960 Summer Olympics,15,PUR,Puerto Rico,24,0,0,0,0
14PUR,1956 Summer Olympics,14,PUR,Puerto Rico,10,0,0,0,0
13PUR,1952 Summer Olympics,13,PUR,Puerto Rico,20,0,0,0,0
12PUR,1948 Summer Olympics,12,PUR,Puerto Rico,9,0,0,1,1
61STP,2020 Summer Olympics,61,STP,São Tomé and Príncipe,2,0,0,0,0
59STP,2016 Summer Olympics,59,STP,São Tomé and Príncipe,2,0,0,0,0
54STP,2012 Summer Olympics,54,STP,São Tomé and Príncipe,2,0,0,0,0
53STP,2008 Summer Olympics,53,STP,São Tomé and Príncipe,3,0,0,0,0
26STP,2004 Summer Olympics,26,STP,São Tomé and Príncipe,2,0,0,0,0
25STP,2000 Summer Olympics,25,STP,São Tomé and Príncipe,2,0,0,0,0
24STP,1996 Summer Olympics,24,STP,São Tomé and Príncipe,2,0,0,0,0
61SAM,2020 Summer Olympics,61,SAM,Samoa,5,0,0,0,0
59SAM,2016 Summer Olympics,59,SAM,Samoa,8,0,0,0,0
54SAM,2012 Summer Olympics,54,SAM,Samoa,6,0,0,0,0
53SAM,2008 Summer Olympics,53,SAM,Samoa,5,0,1,0,1
26SAM,2004 Summer Olympics,26,SAM,Samoa,3,0,0,0,0
25SAM,2000 Summer Olympics,25,SAM,Samoa,4,0,0,0,0
24SAM,1996 Summer Olympics,24,SAM,Samoa,5,0,0,0,0
23SAM,1992 Summer Olympics,23,SAM,Samoa,3,0,0,0,0
22SAM,1988 Summer Olympics,22,SAM,Samoa,10,0,0,0,0
21SAM,1984 Summer Olympics,21,SAM,Samoa,8,0,0,0,0
61VIN,2020 Summer Olympics,61,VIN,Saint Vincent and the Grenadines,3,0,0,0,0
59VIN,2016 Summer Olympics,59,VIN,Saint Vincent and the Grenadines,3,0,0,0,0
54VIN,2012 Summer Olympics,54,VIN,Saint Vincent and the Grenadines,2,0,0,0,0
53VIN,2008 Summer Olympics,53,VIN,Saint Vincent and the Grenadines,2,0,0,0,0
26VIN,2004 Summer Olympics,26,VIN,Saint Vincent and the Grenadines,2,0,0,0,0
25VIN,2000 Summer Olympics,25,VIN,Saint Vincent and the Grenadines,3,0,0,0,0
24VIN,1996 Summer Olympics,24,VIN,Saint Vincent and the Grenadines,6,0,0,0,0
23VIN,1992 Summer Olympics,23,VIN,Saint Vincent and the Grenadines,4,0,0,0,0
22VIN,1988 Summer Olympics,22,VIN,Saint Vincent and the Grenadines,8,0,0,0,0
62ROC,2022 Winter Olympics,62,ROC,ROC,146,29,47,23,99
61ROC,2020 Summer Olympics,61,ROC,ROC,337,41,80,27,148
60ROC,2018 Winter Olympics,60,ROC,ROC,168,26,24,12,62
62PHI,2022 Winter Olympics,62,PHI,Philippines,0,0,0,0,0
61PHI,2020 Summer Olympics,61,PHI,Philippines,18,1,2,1,4
60PHI,2018 Winter Olympics,60,PHI,Philippines,1,0,0,0,0
59PHI,2016 Summer Olympics,59,PHI,Philippines,9,0,1,0,1
58PHI,2014 Winter Olympics,58,PHI,Philippines,1,0,0,0,0
54PHI,2012 Summer Olympics,54,PHI,Philippines,8,0,0,0,0
53PHI,2008 Summer Olympics,53,PHI,Philippines,13,0,0,0,0
26PHI,2004 Summer Olympics,26,PHI,Philippines,11,0,0,0,0
25PHI,2000 Summer Olympics,25,PHI,Philippines,19,0,0,0,0
24PHI,1996 Summer Olympics,24,PHI,Philippines,8,0,1,0,1
44PHI,1992 Winter Olympics,44,PHI,Philippines,1,0,0,0,0
23PHI,1992 Summer Olympics,23,PHI,Philippines,20,0,0,1,1
43PHI,1988 Winter Olympics,43,PHI,Philippines,1,0,0,0,0
22PHI,1988 Summer Olympics,22,PHI,Philippines,30,0,0,1,1
21PHI,1984 Summer Olympics,21,PHI,Philippines,19,0,0,0,0
19PHI,1976 Summer Olympics,19,PHI,Philippines,6,0,0,0,0
39PHI,1972 Winter Olympics,39,PHI,Philippines,2,0,0,0,0
18PHI,1972 Summer Olympics,18,PHI,Philippines,41,0,0,0,0
17PHI,1968 Summer Olympics,17,PHI,Philippines,36,0,0,0,0
16PHI,1964 Summer Olympics,16,PHI,Philippines,39,0,1,0,1
15PHI,1960 Summer Olympics,15,PHI,Philippines,35,0,0,0,0
14PHI,1956 Summer Olympics,14,PHI,Philippines,30,0,0,0,0
13PHI,1952 Summer Olympics,13,PHI,Philippines,19,0,0,0,0
12PHI,1948 Summer Olympics,12,PHI,Philippines,24,0,0,0,0
11PHI,1936 Summer Olympics,11,PHI,Philippines,26,0,0,1,1
10PHI,1932 Summer Olympics,10,PHI,Philippines,6,0,0,3,3
9PHI,1928 Summer Olympics,9,PHI,Philippines,4,0,0,1,1
8PHI,1924 Summer Olympics,8,PHI,Philippines,3,0,0,0,0
61LCA,2020 Summer Olympics,61,LCA,Saint Lucia,3,0,0,0,0
59LCA,2016 Summer Olympics,59,LCA,Saint Lucia,4,0,0,0,0
54LCA,2012 Summer Olympics,54,LCA,Saint Lucia,2,0,0,0,0
53LCA,2008 Summer Olympics,53,LCA,Saint Lucia,3,0,0,0,0
26LCA,2004 Summer Olympics,26,LCA,Saint Lucia,2,0,0,0,0
25LCA,2000 Summer Olympics,25,LCA,Saint Lucia,4,0,0,0,0
24LCA,1996 Summer Olympics,24,LCA,Saint Lucia,5,0,0,0,0
61SKN,2020 Summer Olympics,61,SKN,Saint Kitts and Nevis,1,0,0,0,0
59SKN,2016 Summer Olympics,59,SKN,Saint Kitts and Nevis,2,0,0,0,0
54SKN,2012 Summer Olympics,54,SKN,Saint Kitts and Nevis,4,0,0,0,0
53SKN,2008 Summer Olympics,53,SKN,Saint Kitts and Nevis,2,0,0,0,0
26SKN,2004 Summer Olympics,26,SKN,Saint Kitts and Nevis,1,0,0,0,0
25SKN,2000 Summer Olympics,25,SKN,Saint Kitts and Nevis,0,0,0,0,0
24SKN,1996 Summer Olympics,24,SKN,Saint Kitts and Nevis,10,0,0,0,0
61RWA,2020 Summer Olympics,61,RWA,Rwanda,3,0,0,0,0
59RWA,2016 Summer Olympics,59,RWA,Rwanda,5,0,0,0,0
54RWA,2012 Summer Olympics,54,RWA,Rwanda,6,0,0,0,0
53RWA,2008 Summer Olympics,53,RWA,Rwanda,1,0,0,0,0
26RWA,2004 Summer Olympics,26,RWA,Rwanda,3,0,0,0,0
25RWA,2000 Summer Olympics,25,RWA,Rwanda,3,0,0,0,0
24RWA,1996 Summer Olympics,24,RWA,Rwanda,3,0,0,0,0
23RWA,1992 Summer Olympics,23,RWA,Rwanda,8,0,0,0,0
22RWA,1988 Summer Olympics,22,RWA,Rwanda,5,0,0,0,0
21RWA,1984 Summer Olympics,21,RWA,Rwanda,3,0,0,0,0
62PER,2022 Winter Olympics,62,PER,Peru,0,0,0,0,0
61PER,2020 Summer Olympics,61,PER,Peru,23,0,0,0,0
59PER,2016 Summer Olympics,59,PER,Peru,22,0,0,0,0
58PER,2014 Winter Olympics,58,PER,Peru,0,0,0,0,0
54PER,2012 Summer Olympics,54,PER,Peru,12,0,0,0,0
57PER,2010 Winter Olympics,57,PER,Peru,3,0,0,0,0
53PER,2008 Summer Olympics,53,PER,Peru,11,0,0,0,0
26PER,2004 Summer Olympics,26,PER,Peru,10,0,0,0,0
25PER,2000 Summer Olympics,25,PER,Peru,12,0,0,0,0
24PER,1996 Summer Olympics,24,PER,Peru,27,0,0,0,0
23PER,1992 Summer Olympics,23,PER,Peru,10,0,1,0,1
22PER,1988 Summer Olympics,22,PER,Peru,8,0,12,0,12
21PER,1984 Summer Olympics,21,PER,Peru,27,0,1,0,1
20PER,1980 Summer Olympics,20,PER,Peru,23,0,0,0,0
19PER,1976 Summer Olympics,19,PER,Peru,8,0,0,0,0
18PER,1972 Summer Olympics,18,PER,Peru,16,0,0,0,0
17PER,1968 Summer Olympics,17,PER,Peru,27,0,0,0,0
16PER,1964 Summer Olympics,16,PER,Peru,23,0,0,0,0
15PER,1960 Summer Olympics,15,PER,Peru,28,0,0,0,0
14PER,1956 Summer Olympics,14,PER,Peru,8,0,0,0,0
12PER,1948 Summer Olympics,12,PER,Peru,43,1,0,0,1
11PER,1936 Summer Olympics,11,PER,Peru,60,0,0,0,0
10PER,1932 Summer Olympics,10,PER,Peru,2,0,0,0,0
2PER,1900 Summer Olympics,2,PER,Peru,6,0,0,0,0
62MDA,2022 Winter Olympics,62,MDA,Republic of Moldova,5,0,0,0,0
61MDA,2020 Summer Olympics,61,MDA,Republic of Moldova,12,0,0,1,1
60MDA,2018 Winter Olympics,60,MDA,Republic of Moldova,2,0,0,0,0
59MDA,2016 Summer Olympics,59,MDA,Republic of Moldova,15,0,0,0,0
58MDA,2014 Winter Olympics,58,MDA,Republic of Moldova,1,0,0,0,0
54MDA,2012 Summer Olympics,54,MDA,Republic of Moldova,14,0,0,0,0
57MDA,2010 Winter Olympics,57,MDA,Republic of Moldova,5,0,0,0,0
53MDA,2008 Summer Olympics,53,MDA,Republic of Moldova,12,0,0,1,1
49MDA,2006 Winter Olympics,49,MDA,Republic of Moldova,3,0,0,0,0
26MDA,2004 Summer Olympics,26,MDA,Republic of Moldova,14,0,0,0,0
47MDA,2002 Winter Olympics,47,MDA,Republic of Moldova,3,0,0,0,0
25MDA,2000 Summer Olympics,25,MDA,Republic of Moldova,21,0,1,1,2
46MDA,1998 Winter Olympics,46,MDA,Republic of Moldova,1,0,0,0,0
24MDA,1996 Summer Olympics,24,MDA,Republic of Moldova,39,0,2,1,3
45MDA,1994 Winter Olympics,45,MDA,Republic of Moldova,2,0,0,0,0
13SAA,1952 Summer Olympics,13,SAA,Saar,36,0,0,0,0
62PAK,2022 Winter Olympics,62,PAK,Pakistan,0,0,0,0,0
61PAK,2020 Summer Olympics,61,PAK,Pakistan,7,0,0,0,0
60PAK,2018 Winter Olympics,60,PAK,Pakistan,1,0,0,0,0
59PAK,2016 Summer Olympics,59,PAK,Pakistan,7,0,0,0,0
58PAK,2014 Winter Olympics,58,PAK,Pakistan,1,0,0,0,0
54PAK,2012 Summer Olympics,54,PAK,Pakistan,15,0,0,0,0
57PAK,2010 Winter Olympics,57,PAK,Pakistan,1,0,0,0,0
53PAK,2008 Summer Olympics,53,PAK,Pakistan,18,0,0,0,0
26PAK,2004 Summer Olympics,26,PAK,Pakistan,18,0,0,0,0
25PAK,2000 Summer Olympics,25,PAK,Pakistan,22,0,0,0,0
24PAK,1996 Summer Olympics,24,PAK,Pakistan,18,0,0,0,0
23PAK,1992 Summer Olympics,23,PAK,Pakistan,17,0,0,16,16
22PAK,1988 Summer Olympics,22,PAK,Pakistan,24,0,0,1,1
21PAK,1984 Summer Olympics,21,PAK,Pakistan,29,16,0,0,16
19PAK,1976 Summer Olympics,19,PAK,Pakistan,12,0,0,16,16
18PAK,1972 Summer Olympics,18,PAK,Pakistan,21,0,18,0,18
17PAK,1968 Summer Olympics,17,PAK,Pakistan,14,18,0,0,18
16PAK,1964 Summer Olympics,16,PAK,Pakistan,27,0,18,0,18
15PAK,1960 Summer Olympics,15,PAK,Pakistan,27,18,0,1,19
14PAK,1956 Summer Olympics,14,PAK,Pakistan,44,0,18,0,18
13PAK,1952 Summer Olympics,13,PAK,Pakistan,31,0,0,0,0
12PAK,1948 Summer Olympics,12,PAK,Pakistan,39,0,0,0,0
62NGR,2022 Winter Olympics,62,NGR,Nigeria,1,0,0,0,0
61NGR,2020 Summer Olympics,61,NGR,Nigeria,46,0,1,1,2
60NGR,2018 Winter Olympics,60,NGR,Nigeria,3,0,0,0,0
59NGR,2016 Summer Olympics,59,NGR,Nigeria,57,0,0,22,22
54NGR,2012 Summer Olympics,54,NGR,Nigeria,34,0,0,0,0
53NGR,2008 Summer Olympics,53,NGR,Nigeria,58,0,24,2,26
26NGR,2004 Summer Olympics,26,NGR,Nigeria,64,0,0,13,13
25NGR,2000 Summer Olympics,25,NGR,Nigeria,72,6,2,0,8
24NGR,1996 Summer Olympics,24,NGR,Nigeria,56,23,4,3,30
23NGR,1992 Summer Olympics,23,NGR,Nigeria,46,0,7,4,11
22NGR,1988 Summer Olympics,22,NGR,Nigeria,62,0,0,0,0
21NGR,1984 Summer Olympics,21,NGR,Nigeria,27,0,1,5,6
20NGR,1980 Summer Olympics,20,NGR,Nigeria,50,0,0,0,0
18NGR,1972 Summer Olympics,18,NGR,Nigeria,18,0,0,1,1
17NGR,1968 Summer Olympics,17,NGR,Nigeria,41,0,0,0,0
16NGR,1964 Summer Olympics,16,NGR,Nigeria,14,0,0,1,1
15NGR,1960 Summer Olympics,15,NGR,Nigeria,12,0,0,0,0
14NGR,1956 Summer Olympics,14,NGR,Nigeria,6,0,0,0,0
13NGR,1952 Summer Olympics,13,NGR,Nigeria,9,0,0,0,0
61QAT,2020 Summer Olympics,61,QAT,Qatar,9,2,0,2,4
59QAT,2016 Summer Olympics,59,QAT,Qatar,32,0,1,0,1
54QAT,2012 Summer Olympics,54,QAT,Qatar,10,0,1,1,2
53QAT,2008 Summer Olympics,53,QAT,Qatar,16,0,0,0,0
26QAT,2004 Summer Olympics,26,QAT,Qatar,11,0,0,0,0
25QAT,2000 Summer Olympics,25,QAT,Qatar,10,0,0,1,1
24QAT,1996 Summer Olympics,24,QAT,Qatar,7,0,0,0,0
23QAT,1992 Summer Olympics,23,QAT,Qatar,26,0,0,1,1
22QAT,1988 Summer Olympics,22,QAT,Qatar,9,0,0,0,0
21QAT,1984 Summer Olympics,21,QAT,Qatar,28,0,0,0,0
15RHO,1960 Summer Olympics,15,RHO,Rhodesia,12,0,0,0,0
61PAN,2020 Summer Olympics,61,PAN,Panama,7,0,0,0,0
59PAN,2016 Summer Olympics,59,PAN,Panama,7,0,0,0,0
54PAN,2012 Summer Olympics,54,PAN,Panama,6,0,0,0,0
53PAN,2008 Summer Olympics,53,PAN,Panama,3,1,0,0,1
26PAN,2004 Summer Olympics,26,PAN,Panama,3,0,0,0,0
25PAN,2000 Summer Olympics,25,PAN,Panama,3,0,0,0,0
24PAN,1996 Summer Olympics,24,PAN,Panama,7,0,0,0,0
23PAN,1992 Summer Olympics,23,PAN,Panama,3,0,0,0,0
22PAN,1988 Summer Olympics,22,PAN,Panama,3,0,0,0,0
21PAN,1984 Summer Olympics,21,PAN,Panama,8,0,0,0,0
19PAN,1976 Summer Olympics,19,PAN,Panama,7,0,0,0,0
18PAN,1972 Summer Olympics,18,PAN,Panama,5,0,0,0,0
17PAN,1968 Summer Olympics,17,PAN,Panama,15,0,0,0,0
16PAN,1964 Summer Olympics,16,PAN,Panama,9,0,0,0,0
15PAN,1960 Summer Olympics,15,PAN,Panama,7,0,0,0,0
13PAN,1952 Summer Olympics,13,PAN,Panama,5,0,0,0,0
12PAN,1948 Summer Olympics,12,PAN,Panama,1,0,0,2,2
9PAN,1928 Summer Olympics,9,PAN,Panama,1,0,0,0,0
61PAR,2020 Summer Olympics,61,PAR,Paraguay,4,0,0,0,0
59PAR,2016 Summer Olympics,59,PAR,Paraguay,6,0,0,0,0
58PAR,2014 Winter Olympics,58,PAR,Paraguay,1,0,0,0,0
54PAR,2012 Summer Olympics,54,PAR,Paraguay,6,0,0,0,0
53PAR,2008 Summer Olympics,53,PAR,Paraguay,6,0,0,0,0
26PAR,2004 Summer Olympics,26,PAR,Paraguay,26,0,22,0,22
25PAR,2000 Summer Olympics,25,PAR,Paraguay,3,0,0,0,0
24PAR,1996 Summer Olympics,24,PAR,Paraguay,6,0,0,0,0
23PAR,1992 Summer Olympics,23,PAR,Paraguay,28,0,0,0,0
22PAR,1988 Summer Olympics,22,PAR,Paraguay,9,0,0,0,0
21PAR,1984 Summer Olympics,21,PAR,Paraguay,14,0,0,0,0
19PAR,1976 Summer Olympics,19,PAR,Paraguay,3,0,0,0,0
18PAR,1972 Summer Olympics,18,PAR,Paraguay,4,0,0,0,0
17PAR,1968 Summer Olympics,17,PAR,Paraguay,1,0,0,0,0
61EOR,2020 Summer Olympics,61,EOR,Refugee Olympic Team,21,0,0,0,0
59EOR,2016 Summer Olympics,59,EOR,Refugee Olympic Team,10,0,0,0,0
61PNG,2020 Summer Olympics,61,PNG,Papua New Guinea,5,0,0,0,0
59PNG,2016 Summer Olympics,59,PNG,Papua New Guinea,5,0,0,0,0
54PNG,2012 Summer Olympics,54,PNG,Papua New Guinea,5,0,0,0,0
53PNG,2008 Summer Olympics,53,PNG,Papua New Guinea,3,0,0,0,0
26PNG,2004 Summer Olympics,26,PNG,Papua New Guinea,2,0,0,0,0
25PNG,2000 Summer Olympics,25,PNG,Papua New Guinea,5,0,0,0,0
24PNG,1996 Summer Olympics,24,PNG,Papua New Guinea,8,0,0,0,0
23PNG,1992 Summer Olympics,23,PNG,Papua New Guinea,12,0,0,0,0
22PNG,1988 Summer Olympics,22,PNG,Papua New Guinea,10,0,0,0,0
21PNG,1984 Summer Olympics,21,PNG,Papua New Guinea,5,0,0,0,0
19PNG,1976 Summer Olympics,19,PNG,Papua New Guinea,6,0,0,0,0
62MAR,2022 Winter Olympics,62,MAR,Morocco,1,0,0,0,0
61MAR,2020 Summer Olympics,61,MAR,Morocco,34,1,0,0,1
60MAR,2018 Winter Olympics,60,MAR,Morocco,0,0,0,0,0
59MAR,2016 Summer Olympics,59,MAR,Morocco,34,0,0,1,1
58MAR,2014 Winter Olympics,58,MAR,Morocco,2,0,0,0,0
54MAR,2012 Summer Olympics,54,MAR,Morocco,57,0,0,1,1
57MAR,2010 Winter Olympics,57,MAR,Morocco,1,0,0,0,0
53MAR,2008 Summer Olympics,53,MAR,Morocco,30,0,1,1,2
26MAR,2004 Summer Olympics,26,MAR,Morocco,45,2,1,0,3
25MAR,2000 Summer Olympics,25,MAR,Morocco,49,0,1,4,5
24MAR,1996 Summer Olympics,24,MAR,Morocco,26,0,0,2,2
44MAR,1992 Winter Olympics,44,MAR,Morocco,11,0,0,0,0
23MAR,1992 Summer Olympics,23,MAR,Morocco,43,1,1,1,3
43MAR,1988 Winter Olympics,43,MAR,Morocco,1,0,0,0,0
22MAR,1988 Summer Olympics,22,MAR,Morocco,22,1,0,2,3
42MAR,1984 Winter Olympics,42,MAR,Morocco,4,0,0,0,0
21MAR,1984 Summer Olympics,21,MAR,Morocco,36,2,0,0,2
19MAR,1976 Summer Olympics,19,MAR,Morocco,8,0,0,0,0
18MAR,1972 Summer Olympics,18,MAR,Morocco,32,0,0,0,0
38MAR,1968 Winter Olympics,38,MAR,Morocco,5,0,0,0,0
17MAR,1968 Summer Olympics,17,MAR,Morocco,22,0,0,0,0
16MAR,1964 Summer Olympics,16,MAR,Morocco,22,0,0,0,0
15MAR,1960 Summer Olympics,15,MAR,Morocco,47,0,1,0,1
62MGL,2022 Winter Olympics,62,MGL,Mongolia,1,0,0,0,0
61MGL,2020 Summer Olympics,61,MGL,Mongolia,27,0,1,3,4
60MGL,2018 Winter Olympics,60,MGL,Mongolia,1,0,0,0,0
59MGL,2016 Summer Olympics,59,MGL,Mongolia,27,0,1,1,2
58MGL,2014 Winter Olympics,58,MGL,Mongolia,2,0,0,0,0
54MGL,2012 Summer Olympics,54,MGL,Mongolia,17,0,2,3,5
57MGL,2010 Winter Olympics,57,MGL,Mongolia,0,0,0,0,0
53MGL,2008 Summer Olympics,53,MGL,Mongolia,16,2,2,0,4
49MGL,2006 Winter Olympics,49,MGL,Mongolia,2,0,0,0,0
26MGL,2004 Summer Olympics,26,MGL,Mongolia,15,0,0,1,1
47MGL,2002 Winter Olympics,47,MGL,Mongolia,2,0,0,0,0
25MGL,2000 Summer Olympics,25,MGL,Mongolia,12,0,0,0,0
46MGL,1998 Winter Olympics,46,MGL,Mongolia,3,0,0,0,0
24MGL,1996 Summer Olympics,24,MGL,Mongolia,11,0,0,1,1
45MGL,1994 Winter Olympics,45,MGL,Mongolia,1,0,0,0,0
44MGL,1992 Winter Olympics,44,MGL,Mongolia,3,0,0,0,0
23MGL,1992 Summer Olympics,23,MGL,Mongolia,24,0,0,2,2
43MGL,1988 Winter Olympics,43,MGL,Mongolia,3,0,0,0,0
22MGL,1988 Summer Olympics,22,MGL,Mongolia,26,0,0,1,1
42MGL,1984 Winter Olympics,42,MGL,Mongolia,3,0,0,0,0
41MGL,1980 Winter Olympics,41,MGL,Mongolia,3,0,0,0,0
20MGL,1980 Summer Olympics,20,MGL,Mongolia,30,0,2,2,4
19MGL,1976 Summer Olympics,19,MGL,Mongolia,19,0,1,0,1
39MGL,1972 Winter Olympics,39,MGL,Mongolia,2,0,0,0,0
18MGL,1972 Summer Olympics,18,MGL,Mongolia,30,0,1,0,1
38MGL,1968 Winter Olympics,38,MGL,Mongolia,2,0,0,0,0
17MGL,1968 Summer Olympics,17,MGL,Mongolia,5,0,1,3,4
37MGL,1964 Winter Olympics,37,MGL,Mongolia,13,0,0,0,0
16MGL,1964 Summer Olympics,16,MGL,Mongolia,21,0,0,0,0
61PLE,2020 Summer Olympics,61,PLE,Palestine,5,0,0,0,0
59PLE,2016 Summer Olympics,59,PLE,Palestine,5,0,0,0,0
54PLE,2012 Summer Olympics,54,PLE,Palestine,5,0,0,0,0
53PLE,2008 Summer Olympics,53,PLE,Palestine,4,0,0,0,0
26PLE,2004 Summer Olympics,26,PLE,Palestine,3,0,0,0,0
25PLE,2000 Summer Olympics,25,PLE,Palestine,1,0,0,0,0
24PLE,1996 Summer Olympics,24,PLE,Palestine,1,0,0,0,0
61OMA,2020 Summer Olympics,61,OMA,Oman,2,0,0,0,0
59OMA,2016 Summer Olympics,59,OMA,Oman,3,0,0,0,0
54OMA,2012 Summer Olympics,54,OMA,Oman,4,0,0,0,0
53OMA,2008 Summer Olympics,53,OMA,Oman,3,0,0,0,0
26OMA,2004 Summer Olympics,26,OMA,Oman,1,0,0,0,0
25OMA,2000 Summer Olympics,25,OMA,Oman,5,0,0,0,0
24OMA,1996 Summer Olympics,24,OMA,Oman,3,0,0,0,0
23OMA,1992 Summer Olympics,23,OMA,Oman,3,0,0,0,0
22OMA,1988 Summer Olympics,22,OMA,Oman,7,0,0,0,0
21OMA,1984 Summer Olympics,21,OMA,Oman,16,0,0,0,0
61PLW,2020 Summer Olympics,61,PLW,Palau,2,0,0,0,0
59PLW,2016 Summer Olympics,59,PLW,Palau,3,0,0,0,0
54PLW,2012 Summer Olympics,54,PLW,Palau,5,0,0,0,0
53PLW,2008 Summer Olympics,53,PLW,Palau,4,0,0,0,0
26PLW,2004 Summer Olympics,26,PLW,Palau,4,0,0,0,0
25PLW,2000 Summer Olympics,25,PLW,Palau,5,0,0,0,0
62MKD,2022 Winter Olympics,62,MKD,North Macedonia,1,0,0,0,0
61MKD,2020 Summer Olympics,61,MKD,North Macedonia,8,0,1,0,1
60MKD,2018 Winter Olympics,60,MKD,North Macedonia,2,0,0,0,0
59MKD,2016 Summer Olympics,59,MKD,North Macedonia,5,0,0,0,0
58MKD,2014 Winter Olympics,58,MKD,North Macedonia,1,0,0,0,0
54MKD,2012 Summer Olympics,54,MKD,North Macedonia,4,0,0,0,0
57MKD,2010 Winter Olympics,57,MKD,North Macedonia,2,0,0,0,0
53MKD,2008 Summer Olympics,53,MKD,North Macedonia,7,0,0,0,0
49MKD,2006 Winter Olympics,49,MKD,North Macedonia,3,0,0,0,0
26MKD,2004 Summer Olympics,26,MKD,North Macedonia,2,0,0,0,0
47MKD,2002 Winter Olympics,47,MKD,North Macedonia,1,0,0,0,0
25MKD,2000 Summer Olympics,25,MKD,North Macedonia,7,0,0,1,1
46MKD,1998 Winter Olympics,46,MKD,North Macedonia,3,0,0,0,0
24MKD,1996 Summer Olympics,24,MKD,North Macedonia,8,0,0,0,0
62FIN,2022 Winter Olympics,62,FIN,Finland,50,26,3,26,55
61FIN,2020 Summer Olympics,61,FIN,Finland,32,0,0,2,2
60FIN,2018 Winter Olympics,60,FIN,Finland,54,1,1,26,28
59FIN,2016 Summer Olympics,59,FIN,Finland,32,0,0,1,1
58FIN,2014 Winter Olympics,58,FIN,Finland,58,2,7,25,34
54FIN,2012 Summer Olympics,54,FIN,Finland,30,0,2,3,5
57FIN,2010 Winter Olympics,57,FIN,Finland,47,0,1,49,50
53FIN,2008 Summer Olympics,53,FIN,Finland,45,1,2,2,5
49FIN,2006 Winter Olympics,49,FIN,Finland,49,0,36,7,43
26FIN,2004 Summer Olympics,26,FIN,Finland,29,0,2,0,2
47FIN,2002 Winter Olympics,47,FIN,Finland,54,7,5,1,13
25FIN,2000 Summer Olympics,25,FIN,Finland,46,3,1,1,5
46FIN,1998 Winter Olympics,46,FIN,Finland,54,2,7,50,59
24FIN,1996 Summer Olympics,24,FIN,Finland,40,1,2,1,4
45FIN,1994 Winter Olympics,45,FIN,Finland,34,0,1,30,31
44FIN,1992 Winter Olympics,44,FIN,Finland,46,6,1,6,13
23FIN,1992 Summer Olympics,23,FIN,Finland,58,1,4,2,7
43FIN,1988 Winter Olympics,43,FIN,Finland,40,7,23,5,35
22FIN,1988 Summer Olympics,22,FIN,Finland,50,1,1,2,4
42FIN,1984 Winter Olympics,42,FIN,Finland,34,4,3,12,19
21FIN,1984 Summer Olympics,21,FIN,Finland,60,4,2,6,12
41FIN,1980 Winter Olympics,41,FIN,Finland,38,1,5,6,12
20FIN,1980 Summer Olympics,20,FIN,Finland,80,3,1,5,9
40FIN,1976 Winter Olympics,40,FIN,Finland,27,5,10,1,16
19FIN,1976 Summer Olympics,19,FIN,Finland,56,4,2,0,6
39FIN,1972 Winter Olympics,39,FIN,Finland,31,0,9,1,10
18FIN,1972 Summer Olympics,18,FIN,Finland,75,3,1,6,10
38FIN,1968 Winter Olympics,38,FIN,Finland,35,1,2,5,8
17FIN,1968 Summer Olympics,17,FIN,Finland,46,1,2,1,4
37FIN,1964 Winter Olympics,37,FIN,Finland,30,3,7,5,15
16FIN,1964 Summer Olympics,16,FIN,Finland,61,3,0,2,5
36FIN,1960 Winter Olympics,36,FIN,Finland,37,5,3,5,13
15FIN,1960 Summer Olympics,15,FIN,Finland,79,1,1,4,6
48FIN,1956 Equestrian Olympics,48,FIN,Finland,6,0,0,0,0
35FIN,1956 Winter Olympics,35,FIN,Finland,18,5,6,1,12
14FIN,1956 Summer Olympics,14,FIN,Finland,38,3,1,22,26
34FIN,1952 Winter Olympics,34,FIN,Finland,55,6,4,2,12
13FIN,1952 Summer Olympics,13,FIN,Finland,268,8,3,29,40
33FIN,1948 Winter Olympics,33,FIN,Finland,27,1,6,2,9
12FIN,1948 Summer Olympics,12,FIN,Finland,124,17,8,8,33
32FIN,1936 Winter Olympics,32,FIN,Finland,20,4,2,3,9
11FIN,1936 Summer Olympics,11,FIN,Finland,93,8,6,13,27
31FIN,1932 Winter Olympics,31,FIN,Finland,3,1,1,1,3
10FIN,1932 Summer Olympics,10,FIN,Finland,24,5,8,16,29
30FIN,1928 Winter Olympics,30,FIN,Finland,15,2,1,1,4
9FIN,1928 Summer Olympics,9,FIN,Finland,54,8,8,9,25
29FIN,1924 Winter Olympics,29,FIN,Finland,14,4,8,3,15
8FIN,1924 Summer Olympics,8,FIN,Finland,86,24,13,15,52
7FIN,1920 Summer Olympics,7,FIN,Finland,42,21,14,17,52
6FIN,1912 Summer Olympics,6,FIN,Finland,149,9,40,22,71
5FIN,1908 Summer Olympics,5,FIN,Finland,63,1,1,28,30
61NIG,2020 Summer Olympics,61,NIG,Niger,5,0,0,0,0
59NIG,2016 Summer Olympics,59,NIG,Niger,6,0,1,0,1
54NIG,2012 Summer Olympics,54,NIG,Niger,6,0,0,0,0
53NIG,2008 Summer Olympics,53,NIG,Niger,5,0,0,0,0
26NIG,2004 Summer Olympics,26,NIG,Niger,4,0,0,0,0
25NIG,2000 Summer Olympics,25,NIG,Niger,4,0,0,0,0
24NIG,1996 Summer Olympics,24,NIG,Niger,1,0,0,0,0
23NIG,1992 Summer Olympics,23,NIG,Niger,2,0,0,0,0
22NIG,1988 Summer Olympics,22,NIG,Niger,8,0,0,0,0
21NIG,1984 Summer Olympics,21,NIG,Niger,4,0,0,0,0
18NIG,1972 Summer Olympics,18,NIG,Niger,3,0,0,1,1
17NIG,1968 Summer Olympics,17,NIG,Niger,1,0,0,0,0
16NIG,1964 Summer Olympics,16,NIG,Niger,1,0,0,0,0
61NCA,2020 Summer Olympics,61,NCA,Nicaragua,7,0,0,0,0
59NCA,2016 Summer Olympics,59,NCA,Nicaragua,4,0,0,0,0
54NCA,2012 Summer Olympics,54,NCA,Nicaragua,4,0,0,0,0
53NCA,2008 Summer Olympics,53,NCA,Nicaragua,5,0,0,0,0
26NCA,2004 Summer Olympics,26,NCA,Nicaragua,5,0,0,0,0
25NCA,2000 Summer Olympics,25,NCA,Nicaragua,4,0,0,0,0
24NCA,1996 Summer Olympics,24,NCA,Nicaragua,25,0,0,0,0
23NCA,1992 Summer Olympics,23,NCA,Nicaragua,8,0,0,0,0
21NCA,1984 Summer Olympics,21,NCA,Nicaragua,25,0,0,0,0
20NCA,1980 Summer Olympics,20,NCA,Nicaragua,5,0,0,0,0
19NCA,1976 Summer Olympics,19,NCA,Nicaragua,15,0,0,0,0
18NCA,1972 Summer Olympics,18,NCA,Nicaragua,6,0,0,0,0
17NCA,1968 Summer Olympics,17,NCA,Nicaragua,11,0,0,0,0
62MON,2022 Winter Olympics,62,MON,Monaco,0,0,0,0,0
61MON,2020 Summer Olympics,61,MON,Monaco,6,0,0,0,0
60MON,2018 Winter Olympics,60,MON,Monaco,2,0,0,0,0
59MON,2016 Summer Olympics,59,MON,Monaco,1,0,0,0,0
58MON,2014 Winter Olympics,58,MON,Monaco,1,0,0,0,0
54MON,2012 Summer Olympics,54,MON,Monaco,4,0,0,0,0
57MON,2010 Winter Olympics,57,MON,Monaco,0,0,0,0,0
53MON,2008 Summer Olympics,53,MON,Monaco,3,0,0,0,0
49MON,2006 Winter Olympics,49,MON,Monaco,3,0,0,0,0
26MON,2004 Summer Olympics,26,MON,Monaco,1,0,0,0,0
47MON,2002 Winter Olympics,47,MON,Monaco,3,0,0,0,0
25MON,2000 Summer Olympics,25,MON,Monaco,2,0,0,0,0
46MON,1998 Winter Olympics,46,MON,Monaco,1,0,0,0,0
24MON,1996 Summer Olympics,24,MON,Monaco,1,0,0,0,0
45MON,1994 Winter Olympics,45,MON,Monaco,1,0,0,0,0
44MON,1992 Winter Olympics,44,MON,Monaco,3,0,0,0,0
23MON,1992 Summer Olympics,23,MON,Monaco,1,0,0,0,0
43MON,1988 Winter Olympics,43,MON,Monaco,2,0,0,0,0
22MON,1988 Summer Olympics,22,MON,Monaco,6,0,0,0,0
42MON,1984 Winter Olympics,42,MON,Monaco,1,0,0,0,0
21MON,1984 Summer Olympics,21,MON,Monaco,7,0,0,0,0
19MON,1976 Summer Olympics,19,MON,Monaco,3,0,0,0,0
18MON,1972 Summer Olympics,18,MON,Monaco,3,0,0,0,0
17MON,1968 Summer Olympics,17,MON,Monaco,1,0,0,0,0
16MON,1964 Summer Olympics,16,MON,Monaco,1,0,0,0,0
15MON,1960 Summer Olympics,15,MON,Monaco,8,0,0,0,0
13MON,1952 Summer Olympics,13,MON,Monaco,5,0,0,0,0
12MON,1948 Summer Olympics,12,MON,Monaco,0,0,0,0,0
11MON,1936 Summer Olympics,11,MON,Monaco,2,0,0,0,0
10MON,1932 Summer Olympics,10,MON,Monaco,0,0,0,0,0
9MON,1928 Summer Olympics,9,MON,Monaco,10,0,0,0,0
8MON,1924 Summer Olympics,8,MON,Monaco,6,0,0,1,1
7MON,1920 Summer Olympics,7,MON,Monaco,4,0,0,0,0
53AHO,2008 Summer Olympics,53,AHO,Netherlands Antilles,1,0,0,0,0
26AHO,2004 Summer Olympics,26,AHO,Netherlands Antilles,2,0,0,0,0
25AHO,2000 Summer Olympics,25,AHO,Netherlands Antilles,6,0,0,0,0
24AHO,1996 Summer Olympics,24,AHO,Netherlands Antilles,4,0,0,0,0
44AHO,1992 Winter Olympics,44,AHO,Netherlands Antilles,1,0,0,0,0
23AHO,1992 Summer Olympics,23,AHO,Netherlands Antilles,4,0,0,0,0
43AHO,1988 Winter Olympics,43,AHO,Netherlands Antilles,2,0,0,0,0
22AHO,1988 Summer Olympics,22,AHO,Netherlands Antilles,2,0,1,0,1
21AHO,1984 Summer Olympics,21,AHO,Netherlands Antilles,7,0,0,0,0
19AHO,1976 Summer Olympics,19,AHO,Netherlands Antilles,4,0,0,0,0
18AHO,1972 Summer Olympics,18,AHO,Netherlands Antilles,1,0,0,0,0
17AHO,1968 Summer Olympics,17,AHO,Netherlands Antilles,2,0,0,0,0
16AHO,1964 Summer Olympics,16,AHO,Netherlands Antilles,2,0,0,0,0
15AHO,1960 Summer Olympics,15,AHO,Netherlands Antilles,5,0,0,0,0
13AHO,1952 Summer Olympics,13,AHO,Netherlands Antilles,20,0,0,0,0
61NEP,2020 Summer Olympics,61,NEP,Nepal,4,0,0,0,0
59NEP,2016 Summer Olympics,59,NEP,Nepal,7,0,0,0,0
58NEP,2014 Winter Olympics,58,NEP,Nepal,0,0,0,0,0
54NEP,2012 Summer Olympics,54,NEP,Nepal,4,0,0,0,0
57NEP,2010 Winter Olympics,57,NEP,Nepal,0,0,0,0,0
53NEP,2008 Summer Olympics,53,NEP,Nepal,8,0,0,0,0
49NEP,2006 Winter Olympics,49,NEP,Nepal,1,0,0,0,0
26NEP,2004 Summer Olympics,26,NEP,Nepal,6,0,0,0,0
47NEP,2002 Winter Olympics,47,NEP,Nepal,1,0,0,0,0
25NEP,2000 Summer Olympics,25,NEP,Nepal,5,0,0,0,0
24NEP,1996 Summer Olympics,24,NEP,Nepal,5,0,0,0,0
23NEP,1992 Summer Olympics,23,NEP,Nepal,2,0,0,0,0
22NEP,1988 Summer Olympics,22,NEP,Nepal,16,0,0,0,0
21NEP,1984 Summer Olympics,21,NEP,Nepal,9,0,0,0,0
20NEP,1980 Summer Olympics,20,NEP,Nepal,10,0,0,0,0
19NEP,1976 Summer Olympics,19,NEP,Nepal,1,0,0,0,0
18NEP,1972 Summer Olympics,18,NEP,Nepal,2,0,0,0,0
16NEP,1964 Summer Olympics,16,NEP,Nepal,6,0,0,0,0
29NEP,1924 Winter Olympics,29,NEP,Nepal,0,21,0,0,21
62LUX,2022 Winter Olympics,62,LUX,Luxembourg,1,0,0,0,0
61LUX,2020 Summer Olympics,61,LUX,Luxembourg,6,0,0,0,0
60LUX,2018 Winter Olympics,60,LUX,Luxembourg,1,0,0,0,0
59LUX,2016 Summer Olympics,59,LUX,Luxembourg,4,0,0,0,0
58LUX,2014 Winter Olympics,58,LUX,Luxembourg,1,0,0,0,0
54LUX,2012 Summer Olympics,54,LUX,Luxembourg,4,0,0,0,0
53LUX,2008 Summer Olympics,53,LUX,Luxembourg,8,0,0,0,0
49LUX,2006 Winter Olympics,49,LUX,Luxembourg,1,0,0,0,0
26LUX,2004 Summer Olympics,26,LUX,Luxembourg,7,0,0,0,0
25LUX,2000 Summer Olympics,25,LUX,Luxembourg,5,0,0,0,0
46LUX,1998 Winter Olympics,46,LUX,Luxembourg,1,0,0,0,0
24LUX,1996 Summer Olympics,24,LUX,Luxembourg,5,0,0,0,0
45LUX,1994 Winter Olympics,45,LUX,Luxembourg,0,0,0,0,0
44LUX,1992 Winter Olympics,44,LUX,Luxembourg,0,0,2,0,2
23LUX,1992 Summer Olympics,23,LUX,Luxembourg,3,0,0,0,0
43LUX,1988 Winter Olympics,43,LUX,Luxembourg,1,0,0,0,0
22LUX,1988 Summer Olympics,22,LUX,Luxembourg,7,0,0,0,0
21LUX,1984 Summer Olympics,21,LUX,Luxembourg,3,0,0,0,0
20LUX,1980 Summer Olympics,20,LUX,Luxembourg,2,0,0,0,0
19LUX,1976 Summer Olympics,19,LUX,Luxembourg,5,0,0,0,0
18LUX,1972 Summer Olympics,18,LUX,Luxembourg,10,0,0,0,0
17LUX,1968 Summer Olympics,17,LUX,Luxembourg,3,0,0,0,0
16LUX,1964 Summer Olympics,16,LUX,Luxembourg,5,0,0,0,0
15LUX,1960 Summer Olympics,15,LUX,Luxembourg,45,0,0,0,0
14LUX,1956 Summer Olympics,14,LUX,Luxembourg,4,0,0,0,0
13LUX,1952 Summer Olympics,13,LUX,Luxembourg,36,1,0,0,1
12LUX,1948 Summer Olympics,12,LUX,Luxembourg,55,0,0,0,0
32LUX,1936 Winter Olympics,32,LUX,Luxembourg,3,0,0,0,0
11LUX,1936 Summer Olympics,11,LUX,Luxembourg,51,0,0,0,0
10LUX,1932 Summer Olympics,10,LUX,Luxembourg,2,0,0,0,0
30LUX,1928 Winter Olympics,30,LUX,Luxembourg,5,0,0,0,0
9LUX,1928 Summer Olympics,9,LUX,Luxembourg,51,1,0,0,1
8LUX,1924 Summer Olympics,8,LUX,Luxembourg,59,1,1,0,2
7LUX,1920 Summer Olympics,7,LUX,Luxembourg,29,0,1,0,1
6LUX,1912 Summer Olympics,6,LUX,Luxembourg,22,0,0,0,0
61MYA,2020 Summer Olympics,61,MYA,Myanmar,1,0,0,0,0
59MYA,2016 Summer Olympics,59,MYA,Myanmar,7,0,0,0,0
54MYA,2012 Summer Olympics,54,MYA,Myanmar,4,0,0,0,0
53MYA,2008 Summer Olympics,53,MYA,Myanmar,8,0,0,0,0
26MYA,2004 Summer Olympics,26,MYA,Myanmar,2,0,0,0,0
25MYA,2000 Summer Olympics,25,MYA,Myanmar,7,0,0,0,0
24MYA,1996 Summer Olympics,24,MYA,Myanmar,2,0,0,0,0
23MYA,1992 Summer Olympics,23,MYA,Myanmar,3,0,0,0,0
22MYA,1988 Summer Olympics,22,MYA,Myanmar,2,0,0,0,0
21MYA,1984 Summer Olympics,21,MYA,Myanmar,1,0,0,0,0
20MYA,1980 Summer Olympics,20,MYA,Myanmar,2,0,0,0,0
18MYA,1972 Summer Olympics,18,MYA,Myanmar,23,0,0,0,0
17MYA,1968 Summer Olympics,17,MYA,Myanmar,2,0,0,0,0
16MYA,1964 Summer Olympics,16,MYA,Myanmar,9,0,0,0,0
15MYA,1960 Summer Olympics,15,MYA,Myanmar,3,0,0,0,0
14MYA,1956 Summer Olympics,14,MYA,Myanmar,10,0,0,0,0
13MYA,1952 Summer Olympics,13,MYA,Myanmar,6,0,0,0,0
12MYA,1948 Summer Olympics,12,MYA,Myanmar,5,0,0,0,0
22YAR,1988 Summer Olympics,22,YAR,North Yemen,8,0,0,0,0
21YAR,1984 Summer Olympics,21,YAR,North Yemen,2,0,0,0,0
62AUS,2022 Winter Olympics,62,AUS,Australia,20,1,2,1,4
61AUS,2020 Summer Olympics,61,AUS,Australia,303,36,28,66,130
60AUS,2018 Winter Olympics,60,AUS,Australia,20,0,2,1,3
59AUS,2016 Summer Olympics,59,AUS,Australia,275,23,34,25,82
58AUS,2014 Winter Olympics,58,AUS,Australia,43,0,2,1,3
54AUS,2012 Summer Olympics,54,AUS,Australia,229,19,36,61,116
57AUS,2010 Winter Olympics,57,AUS,Australia,22,2,1,0,3
53AUS,2008 Summer Olympics,53,AUS,Australia,270,31,42,77,150
49AUS,2006 Winter Olympics,49,AUS,Australia,29,1,0,1,2
26AUS,2004 Summer Olympics,26,AUS,Australia,284,49,79,31,159
47AUS,2002 Winter Olympics,47,AUS,Australia,18,2,0,0,2
25AUS,2000 Summer Olympics,25,AUS,Australia,435,60,69,54,183
46AUS,1998 Winter Olympics,46,AUS,Australia,10,0,0,1,1
24AUS,1996 Summer Olympics,24,AUS,Australia,299,32,16,84,132
45AUS,1994 Winter Olympics,45,AUS,Australia,9,0,0,5,5
44AUS,1992 Winter Olympics,44,AUS,Australia,27,0,0,0,0
23AUS,1992 Summer Olympics,23,AUS,Australia,209,14,27,16,57
43AUS,1988 Winter Olympics,43,AUS,Australia,17,0,0,0,0
22AUS,1988 Summer Olympics,22,AUS,Australia,216,18,6,11,35
42AUS,1984 Winter Olympics,42,AUS,Australia,9,0,0,0,0
21AUS,1984 Summer Olympics,21,AUS,Australia,196,7,17,31,55
41AUS,1980 Winter Olympics,41,AUS,Australia,7,0,0,0,0
20AUS,1980 Summer Olympics,20,AUS,Australia,86,6,2,5,13
40AUS,1976 Winter Olympics,40,AUS,Australia,7,0,0,0,0
19AUS,1976 Summer Olympics,19,AUS,Australia,133,0,16,8,24
39AUS,1972 Winter Olympics,39,AUS,Australia,2,0,0,0,0
18AUS,1972 Summer Olympics,18,AUS,Australia,128,11,7,2,20
38AUS,1968 Winter Olympics,38,AUS,Australia,3,0,0,0,0
17AUS,1968 Summer Olympics,17,AUS,Australia,81,5,37,11,53
37AUS,1964 Winter Olympics,37,AUS,Australia,4,0,0,0,0
16AUS,1964 Summer Olympics,16,AUS,Australia,184,8,6,32,46
36AUS,1960 Winter Olympics,36,AUS,Australia,25,0,0,0,0
15AUS,1960 Summer Olympics,15,AUS,Australia,128,11,24,11,46
48AUS,1956 Equestrian Olympics,48,AUS,Australia,4,0,0,0,0
35AUS,1956 Winter Olympics,35,AUS,Australia,8,0,0,0,0
14AUS,1956 Summer Olympics,14,AUS,Australia,340,34,14,26,74
34AUS,1952 Winter Olympics,34,AUS,Australia,9,0,0,0,0
13AUS,1952 Summer Olympics,13,AUS,Australia,71,7,2,11,20
12AUS,1948 Summer Olympics,12,AUS,Australia,74,2,10,5,17
32AUS,1936 Winter Olympics,32,AUS,Australia,1,0,0,0,0
11AUS,1936 Summer Olympics,11,AUS,Australia,30,0,0,1,1
10AUS,1932 Summer Olympics,10,AUS,Australia,8,3,1,1,5
9AUS,1928 Summer Olympics,9,AUS,Australia,17,1,2,1,4
29AUS,1924 Winter Olympics,29,AUS,Australia,0,21,0,0,21
8AUS,1924 Summer Olympics,8,AUS,Australia,37,3,5,2,10
7AUS,1920 Summer Olympics,7,AUS,Australia,13,0,6,1,7
3AUS,1904 Summer Olympics,3,AUS,Australia,6,0,0,0,0
2AUS,1900 Summer Olympics,2,AUS,Australia,2,0,0,3,3
1AUS,1896 Summer Olympics,1,AUS,Australia,2,2,0,2,4
62LAT,2022 Winter Olympics,62,LAT,Latvia,36,0,0,4,4
61LAT,2020 Summer Olympics,61,LAT,Latvia,24,4,0,1,5
60LAT,2018 Winter Olympics,60,LAT,Latvia,13,0,0,2,2
59LAT,2016 Summer Olympics,59,LAT,Latvia,14,0,0,0,0
58LAT,2014 Winter Olympics,58,LAT,Latvia,25,4,1,8,13
54LAT,2012 Summer Olympics,54,LAT,Latvia,28,1,0,2,3
57LAT,2010 Winter Olympics,57,LAT,Latvia,27,0,3,0,3
53LAT,2008 Summer Olympics,53,LAT,Latvia,32,1,1,1,3
49LAT,2006 Winter Olympics,49,LAT,Latvia,33,0,0,1,1
26LAT,2004 Summer Olympics,26,LAT,Latvia,14,0,4,0,4
47LAT,2002 Winter Olympics,47,LAT,Latvia,32,0,0,0,0
25LAT,2000 Summer Olympics,25,LAT,Latvia,25,1,1,1,3
46LAT,1998 Winter Olympics,46,LAT,Latvia,17,0,0,0,0
24LAT,1996 Summer Olympics,24,LAT,Latvia,31,0,1,0,1
45LAT,1994 Winter Olympics,45,LAT,Latvia,10,0,0,0,0
44LAT,1992 Winter Olympics,44,LAT,Latvia,23,0,0,0,0
23LAT,1992 Summer Olympics,23,LAT,Latvia,34,0,2,1,3
32LAT,1936 Winter Olympics,32,LAT,Latvia,25,0,0,0,0
11LAT,1936 Summer Olympics,11,LAT,Latvia,30,0,1,1,2
10LAT,1932 Summer Olympics,10,LAT,Latvia,3,0,1,0,1
30LAT,1928 Winter Olympics,30,LAT,Latvia,0,0,0,0,0
9LAT,1928 Summer Olympics,9,LAT,Latvia,14,0,0,0,0
29LAT,1924 Winter Olympics,29,LAT,Latvia,1,0,0,0,0
8LAT,1924 Summer Olympics,8,LAT,Latvia,49,0,0,0,0
14NBO,1956 Summer Olympics,14,NBO,North Borneo,2,0,0,0,0
61NAM,2020 Summer Olympics,61,NAM,Namibia,7,0,1,0,1
59NAM,2016 Summer Olympics,59,NAM,Namibia,6,0,0,0,0
54NAM,2012 Summer Olympics,54,NAM,Namibia,5,0,0,0,0
53NAM,2008 Summer Olympics,53,NAM,Namibia,7,0,0,0,0
26NAM,2004 Summer Olympics,26,NAM,Namibia,4,0,0,0,0
25NAM,2000 Summer Olympics,25,NAM,Namibia,7,0,0,0,0
24NAM,1996 Summer Olympics,24,NAM,Namibia,5,0,2,0,2
23NAM,1992 Summer Olympics,23,NAM,Namibia,6,0,2,0,2
61MOZ,2020 Summer Olympics,61,MOZ,Mozambique,8,0,0,0,0
59MOZ,2016 Summer Olympics,59,MOZ,Mozambique,5,0,0,0,0
54MOZ,2012 Summer Olympics,54,MOZ,Mozambique,4,0,0,0,0
53MOZ,2008 Summer Olympics,53,MOZ,Mozambique,3,0,0,0,0
26MOZ,2004 Summer Olympics,26,MOZ,Mozambique,3,0,0,0,0
25MOZ,2000 Summer Olympics,25,MOZ,Mozambique,3,1,0,0,1
24MOZ,1996 Summer Olympics,24,MOZ,Mozambique,1,0,0,1,1
23MOZ,1992 Summer Olympics,23,MOZ,Mozambique,3,0,0,0,0
22MOZ,1988 Summer Olympics,22,MOZ,Mozambique,8,0,0,0,0
21MOZ,1984 Summer Olympics,21,MOZ,Mozambique,8,0,0,0,0
20MOZ,1980 Summer Olympics,20,MOZ,Mozambique,14,0,0,0,0
61NRU,2020 Summer Olympics,61,NRU,Nauru,2,0,0,0,0
59NRU,2016 Summer Olympics,59,NRU,Nauru,2,0,0,0,0
54NRU,2012 Summer Olympics,54,NRU,Nauru,1,0,0,0,0
53NRU,2008 Summer Olympics,53,NRU,Nauru,0,0,0,0,0
26NRU,2004 Summer Olympics,26,NRU,Nauru,3,0,0,0,0
25NRU,2000 Summer Olympics,25,NRU,Nauru,2,0,0,0,0
24NRU,1996 Summer Olympics,24,NRU,Nauru,3,0,0,0,0
62MAS,2022 Winter Olympics,62,MAS,Malaysia,1,0,0,0,0
61MAS,2020 Summer Olympics,61,MAS,Malaysia,13,0,1,2,3
60MAS,2018 Winter Olympics,60,MAS,Malaysia,2,0,0,0,0
59MAS,2016 Summer Olympics,59,MAS,Malaysia,19,0,7,1,8
54MAS,2012 Summer Olympics,54,MAS,Malaysia,18,0,1,1,2
53MAS,2008 Summer Olympics,53,MAS,Malaysia,26,0,1,0,1
26MAS,2004 Summer Olympics,26,MAS,Malaysia,17,0,0,0,0
25MAS,2000 Summer Olympics,25,MAS,Malaysia,24,0,0,0,0
24MAS,1996 Summer Olympics,24,MAS,Malaysia,25,0,2,1,3
23MAS,1992 Summer Olympics,23,MAS,Malaysia,21,0,0,2,2
22MAS,1988 Summer Olympics,22,MAS,Malaysia,13,0,0,0,0
21MAS,1984 Summer Olympics,21,MAS,Malaysia,19,0,0,0,0
19MAS,1976 Summer Olympics,19,MAS,Malaysia,13,0,0,0,0
18MAS,1972 Summer Olympics,18,MAS,Malaysia,50,0,0,0,0
17MAS,1968 Summer Olympics,17,MAS,Malaysia,19,0,0,0,0
16MAS,1964 Summer Olympics,16,MAS,Malaysia,62,0,0,0,0
62LIE,2022 Winter Olympics,62,LIE,Liechtenstein,1,0,0,0,0
61LIE,2020 Summer Olympics,61,LIE,Liechtenstein,3,0,0,0,0
60LIE,2018 Winter Olympics,60,LIE,Liechtenstein,1,0,0,1,1
59LIE,2016 Summer Olympics,59,LIE,Liechtenstein,1,0,0,0,0
58LIE,2014 Winter Olympics,58,LIE,Liechtenstein,2,0,0,0,0
54LIE,2012 Summer Olympics,54,LIE,Liechtenstein,2,0,0,0,0
57LIE,2010 Winter Olympics,57,LIE,Liechtenstein,3,0,0,0,0
53LIE,2008 Summer Olympics,53,LIE,Liechtenstein,1,0,0,0,0
49LIE,2006 Winter Olympics,49,LIE,Liechtenstein,3,0,0,0,0
26LIE,2004 Summer Olympics,26,LIE,Liechtenstein,0,0,0,0,0
47LIE,2002 Winter Olympics,47,LIE,Liechtenstein,2,0,0,0,0
25LIE,2000 Summer Olympics,25,LIE,Liechtenstein,2,0,0,0,0
46LIE,1998 Winter Olympics,46,LIE,Liechtenstein,2,0,0,0,0
24LIE,1996 Summer Olympics,24,LIE,Liechtenstein,0,0,0,0,0
45LIE,1994 Winter Olympics,45,LIE,Liechtenstein,4,0,0,0,0
44LIE,1992 Winter Olympics,44,LIE,Liechtenstein,6,0,0,0,0
23LIE,1992 Summer Olympics,23,LIE,Liechtenstein,4,0,0,0,0
43LIE,1988 Winter Olympics,43,LIE,Liechtenstein,8,0,0,1,1
22LIE,1988 Summer Olympics,22,LIE,Liechtenstein,8,0,0,0,0
42LIE,1984 Winter Olympics,42,LIE,Liechtenstein,5,0,0,2,2
21LIE,1984 Summer Olympics,21,LIE,Liechtenstein,5,0,0,0,0
41LIE,1980 Winter Olympics,41,LIE,Liechtenstein,1,2,2,0,4
40LIE,1976 Winter Olympics,40,LIE,Liechtenstein,8,0,0,2,2
19LIE,1976 Summer Olympics,19,LIE,Liechtenstein,5,0,0,0,0
39LIE,1972 Winter Olympics,39,LIE,Liechtenstein,2,0,0,0,0
18LIE,1972 Summer Olympics,18,LIE,Liechtenstein,6,0,0,0,0
38LIE,1968 Winter Olympics,38,LIE,Liechtenstein,7,0,0,0,0
17LIE,1968 Summer Olympics,17,LIE,Liechtenstein,2,0,0,0,0
37LIE,1964 Winter Olympics,37,LIE,Liechtenstein,6,0,0,0,0
16LIE,1964 Summer Olympics,16,LIE,Liechtenstein,1,0,0,0,0
36LIE,1960 Winter Olympics,36,LIE,Liechtenstein,2,0,0,0,0
15LIE,1960 Summer Olympics,15,LIE,Liechtenstein,5,0,0,0,0
35LIE,1956 Winter Olympics,35,LIE,Liechtenstein,5,0,0,0,0
13LIE,1952 Summer Olympics,13,LIE,Liechtenstein,2,0,0,0,0
33LIE,1948 Winter Olympics,33,LIE,Liechtenstein,9,0,0,0,0
12LIE,1948 Summer Olympics,12,LIE,Liechtenstein,2,0,0,0,0
32LIE,1936 Winter Olympics,32,LIE,Liechtenstein,4,0,0,0,0
11LIE,1936 Summer Olympics,11,LIE,Liechtenstein,6,0,0,0,0
62LTU,2022 Winter Olympics,62,LTU,Lithuania,9,0,0,0,0
61LTU,2020 Summer Olympics,61,LTU,Lithuania,17,0,1,0,1
60LTU,2018 Winter Olympics,60,LTU,Lithuania,3,0,0,0,0
59LTU,2016 Summer Olympics,59,LTU,Lithuania,37,0,2,5,7
58LTU,2014 Winter Olympics,58,LTU,Lithuania,8,0,0,0,0
54LTU,2012 Summer Olympics,54,LTU,Lithuania,36,2,0,3,5
57LTU,2010 Winter Olympics,57,LTU,Lithuania,2,0,0,0,0
53LTU,2008 Summer Olympics,53,LTU,Lithuania,41,0,3,2,5
49LTU,2006 Winter Olympics,49,LTU,Lithuania,3,0,0,0,0
26LTU,2004 Summer Olympics,26,LTU,Lithuania,30,1,2,0,3
47LTU,2002 Winter Olympics,47,LTU,Lithuania,3,0,0,0,0
25LTU,2000 Summer Olympics,25,LTU,Lithuania,33,2,0,15,17
46LTU,1998 Winter Olympics,46,LTU,Lithuania,3,0,0,0,0
24LTU,1996 Summer Olympics,24,LTU,Lithuania,47,0,0,12,12
45LTU,1994 Winter Olympics,45,LTU,Lithuania,0,0,0,0,0
44LTU,1992 Winter Olympics,44,LTU,Lithuania,6,0,0,0,0
23LTU,1992 Summer Olympics,23,LTU,Lithuania,47,1,0,12,13
30LTU,1928 Winter Olympics,30,LTU,Lithuania,1,0,0,0,0
9LTU,1928 Summer Olympics,9,LTU,Lithuania,12,0,0,0,0
8LTU,1924 Summer Olympics,8,LTU,Lithuania,20,0,0,0,0
62MNE,2022 Winter Olympics,62,MNE,Montenegro,1,0,0,0,0
61MNE,2020 Summer Olympics,61,MNE,Montenegro,24,0,0,0,0
60MNE,2018 Winter Olympics,60,MNE,Montenegro,3,0,0,0,0
59MNE,2016 Summer Olympics,59,MNE,Montenegro,11,0,0,0,0
58MNE,2014 Winter Olympics,58,MNE,Montenegro,2,0,0,0,0
54MNE,2012 Summer Olympics,54,MNE,Montenegro,23,0,15,0,15
57MNE,2010 Winter Olympics,57,MNE,Montenegro,1,0,0,0,0
53MNE,2008 Summer Olympics,53,MNE,Montenegro,19,0,0,0,0
62LBN,2022 Winter Olympics,62,LBN,Lebanon,3,0,0,0,0
61LBN,2020 Summer Olympics,61,LBN,Lebanon,3,0,0,0,0
60LBN,2018 Winter Olympics,60,LBN,Lebanon,3,0,0,0,0
59LBN,2016 Summer Olympics,59,LBN,Lebanon,5,0,0,0,0
58LBN,2014 Winter Olympics,58,LBN,Lebanon,1,0,0,0,0
54LBN,2012 Summer Olympics,54,LBN,Lebanon,8,0,0,0,0
57LBN,2010 Winter Olympics,57,LBN,Lebanon,2,0,0,0,0
53LBN,2008 Summer Olympics,53,LBN,Lebanon,6,0,0,0,0
49LBN,2006 Winter Olympics,49,LBN,Lebanon,2,0,0,0,0
26LBN,2004 Summer Olympics,26,LBN,Lebanon,4,0,0,0,0
47LBN,2002 Winter Olympics,47,LBN,Lebanon,2,0,0,0,0
25LBN,2000 Summer Olympics,25,LBN,Lebanon,5,0,0,0,0
24LBN,1996 Summer Olympics,24,LBN,Lebanon,1,0,0,0,0
44LBN,1992 Winter Olympics,44,LBN,Lebanon,3,0,0,0,0
23LBN,1992 Summer Olympics,23,LBN,Lebanon,7,0,0,0,0
43LBN,1988 Winter Olympics,43,LBN,Lebanon,4,0,0,0,0
22LBN,1988 Summer Olympics,22,LBN,Lebanon,17,0,0,0,0
42LBN,1984 Winter Olympics,42,LBN,Lebanon,4,0,0,0,0
21LBN,1984 Summer Olympics,21,LBN,Lebanon,18,0,0,0,0
41LBN,1980 Winter Olympics,41,LBN,Lebanon,4,0,0,0,0
20LBN,1980 Summer Olympics,20,LBN,Lebanon,13,0,0,1,1
40LBN,1976 Winter Olympics,40,LBN,Lebanon,1,0,0,0,0
19LBN,1976 Summer Olympics,19,LBN,Lebanon,3,0,0,0,0
39LBN,1972 Winter Olympics,39,LBN,Lebanon,0,0,0,0,0
18LBN,1972 Summer Olympics,18,LBN,Lebanon,14,0,1,0,1
38LBN,1968 Winter Olympics,38,LBN,Lebanon,3,0,0,0,0
17LBN,1968 Summer Olympics,17,LBN,Lebanon,10,0,0,0,0
37LBN,1964 Winter Olympics,37,LBN,Lebanon,2,0,0,0,0
16LBN,1964 Summer Olympics,16,LBN,Lebanon,2,0,0,0,0
36LBN,1960 Winter Olympics,36,LBN,Lebanon,1,0,0,0,0
15LBN,1960 Summer Olympics,15,LBN,Lebanon,20,0,0,0,0
35LBN,1956 Winter Olympics,35,LBN,Lebanon,2,0,0,0,0
34LBN,1952 Winter Olympics,34,LBN,Lebanon,0,0,0,0,0
13LBN,1952 Summer Olympics,13,LBN,Lebanon,7,0,1,1,2
33LBN,1948 Winter Olympics,33,LBN,Lebanon,2,0,0,0,0
12LBN,1948 Summer Olympics,12,LBN,Lebanon,8,0,0,0,0
62MLT,2022 Winter Olympics,62,MLT,Malta,1,0,0,0,0
61MLT,2020 Summer Olympics,61,MLT,Malta,4,0,0,0,0
60MLT,2018 Winter Olympics,60,MLT,Malta,0,0,0,0,0
59MLT,2016 Summer Olympics,59,MLT,Malta,4,0,0,0,0
58MLT,2014 Winter Olympics,58,MLT,Malta,1,0,0,0,0
54MLT,2012 Summer Olympics,54,MLT,Malta,4,0,0,0,0
53MLT,2008 Summer Olympics,53,MLT,Malta,4,0,0,0,0
26MLT,2004 Summer Olympics,26,MLT,Malta,5,0,0,0,0
25MLT,2000 Summer Olympics,25,MLT,Malta,4,0,0,0,0
24MLT,1996 Summer Olympics,24,MLT,Malta,5,0,0,0,0
23MLT,1992 Summer Olympics,23,MLT,Malta,4,0,0,0,0
22MLT,1988 Summer Olympics,22,MLT,Malta,4,0,0,0,0
21MLT,1984 Summer Olympics,21,MLT,Malta,5,0,0,0,0
20MLT,1980 Summer Olympics,20,MLT,Malta,7,0,0,0,0
18MLT,1972 Summer Olympics,18,MLT,Malta,4,0,0,0,0
17MLT,1968 Summer Olympics,17,MLT,Malta,0,0,0,0,0
15MLT,1960 Summer Olympics,15,MLT,Malta,10,0,0,0,0
12MLT,1948 Summer Olympics,12,MLT,Malta,1,0,0,0,0
11MLT,1936 Summer Olympics,11,MLT,Malta,14,0,0,0,0
9MLT,1928 Summer Olympics,9,MLT,Malta,9,0,0,0,0
61MRI,2020 Summer Olympics,61,MRI,Mauritius,4,0,0,0,0
59MRI,2016 Summer Olympics,59,MRI,Mauritius,8,0,0,0,0
54MRI,2012 Summer Olympics,54,MRI,Mauritius,8,0,0,0,0
53MRI,2008 Summer Olympics,53,MRI,Mauritius,8,0,0,1,1
26MRI,2004 Summer Olympics,26,MRI,Mauritius,5,0,0,0,0
25MRI,2000 Summer Olympics,25,MRI,Mauritius,15,0,0,0,0
24MRI,1996 Summer Olympics,24,MRI,Mauritius,20,0,0,0,0
23MRI,1992 Summer Olympics,23,MRI,Mauritius,12,0,0,0,0
22MRI,1988 Summer Olympics,22,MRI,Mauritius,8,0,0,0,0
21MRI,1984 Summer Olympics,21,MRI,Mauritius,4,0,0,0,0
62GRE,2022 Winter Olympics,62,GRE,Greece,2,0,0,0,0
61GRE,2020 Summer Olympics,61,GRE,Greece,39,2,13,1,16
60GRE,2018 Winter Olympics,60,GRE,Greece,1,0,0,0,0
59GRE,2016 Summer Olympics,59,GRE,Greece,50,3,1,3,7
58GRE,2014 Winter Olympics,58,GRE,Greece,5,0,0,0,0
54GRE,2012 Summer Olympics,54,GRE,Greece,61,0,0,3,3
57GRE,2010 Winter Olympics,57,GRE,Greece,3,0,0,0,0
53GRE,2008 Summer Olympics,53,GRE,Greece,64,0,3,3,6
49GRE,2006 Winter Olympics,49,GRE,Greece,2,0,0,0,0
26GRE,2004 Summer Olympics,26,GRE,Greece,350,8,18,5,31
47GRE,2002 Winter Olympics,47,GRE,Greece,7,0,0,0,0
25GRE,2000 Summer Olympics,25,GRE,Greece,87,4,6,8,18
46GRE,1998 Winter Olympics,46,GRE,Greece,9,0,0,0,0
24GRE,1996 Summer Olympics,24,GRE,Greece,94,4,4,0,8
45GRE,1994 Winter Olympics,45,GRE,Greece,5,0,0,0,0
44GRE,1992 Winter Olympics,44,GRE,Greece,5,0,0,0,0
23GRE,1992 Summer Olympics,23,GRE,Greece,49,2,0,0,2
43GRE,1988 Winter Olympics,43,GRE,Greece,5,0,0,0,0
22GRE,1988 Summer Olympics,22,GRE,Greece,36,0,0,1,1
42GRE,1984 Winter Olympics,42,GRE,Greece,4,0,0,0,0
21GRE,1984 Summer Olympics,21,GRE,Greece,43,0,1,1,2
41GRE,1980 Winter Olympics,41,GRE,Greece,3,0,0,0,0
20GRE,1980 Summer Olympics,20,GRE,Greece,31,1,0,4,5
40GRE,1976 Winter Olympics,40,GRE,Greece,3,0,0,0,0
19GRE,1976 Summer Olympics,19,GRE,Greece,20,0,0,0,0
39GRE,1972 Winter Olympics,39,GRE,Greece,3,0,0,0,0
18GRE,1972 Summer Olympics,18,GRE,Greece,42,0,2,0,2
38GRE,1968 Winter Olympics,38,GRE,Greece,2,0,0,0,0
17GRE,1968 Summer Olympics,17,GRE,Greece,34,0,0,1,1
37GRE,1964 Winter Olympics,37,GRE,Greece,3,0,0,0,0
16GRE,1964 Summer Olympics,16,GRE,Greece,11,0,0,0,0
15GRE,1960 Summer Olympics,15,GRE,Greece,43,3,0,0,3
35GRE,1956 Winter Olympics,35,GRE,Greece,2,0,0,0,0
14GRE,1956 Summer Olympics,14,GRE,Greece,7,0,0,1,1
34GRE,1952 Winter Olympics,34,GRE,Greece,3,0,0,0,0
13GRE,1952 Summer Olympics,13,GRE,Greece,41,0,0,0,0
33GRE,1948 Winter Olympics,33,GRE,Greece,1,0,0,0,0
12GRE,1948 Summer Olympics,12,GRE,Greece,52,0,0,0,0
32GRE,1936 Winter Olympics,32,GRE,Greece,1,0,0,0,0
11GRE,1936 Summer Olympics,11,GRE,Greece,39,0,0,0,0
10GRE,1932 Summer Olympics,10,GRE,Greece,6,0,0,0,0
9GRE,1928 Summer Olympics,9,GRE,Greece,18,0,0,0,0
8GRE,1924 Summer Olympics,8,GRE,Greece,29,1,0,0,1
7GRE,1920 Summer Olympics,7,GRE,Greece,50,0,5,0,5
6GRE,1912 Summer Olympics,6,GRE,Greece,22,1,0,1,2
5GRE,1908 Summer Olympics,5,GRE,Greece,15,0,3,1,4
3GRE,1904 Summer Olympics,3,GRE,Greece,15,1,0,1,2
2GRE,1900 Summer Olympics,2,GRE,Greece,0,0,0,0,0
1GRE,1896 Summer Olympics,1,GRE,Greece,138,10,21,21,52
61MLI,2020 Summer Olympics,61,MLI,Mali,3,0,0,0,0
59MLI,2016 Summer Olympics,59,MLI,Mali,5,0,0,0,0
54MLI,2012 Summer Olympics,54,MLI,Mali,5,0,0,0,0
53MLI,2008 Summer Olympics,53,MLI,Mali,14,0,0,0,0
26MLI,2004 Summer Olympics,26,MLI,Mali,24,0,0,0,0
25MLI,2000 Summer Olympics,25,MLI,Mali,5,0,0,0,0
24MLI,1996 Summer Olympics,24,MLI,Mali,2,0,0,0,0
23MLI,1992 Summer Olympics,23,MLI,Mali,4,0,0,0,0
22MLI,1988 Summer Olympics,22,MLI,Mali,6,0,0,0,0
21MLI,1984 Summer Olympics,21,MLI,Mali,3,0,0,0,0
20MLI,1980 Summer Olympics,20,MLI,Mali,6,0,0,0,0
18MLI,1972 Summer Olympics,18,MLI,Mali,2,0,0,0,0
17MLI,1968 Summer Olympics,17,MLI,Mali,2,0,0,0,0
16MLI,1964 Summer Olympics,16,MLI,Mali,2,0,0,0,0
61MTN,2020 Summer Olympics,61,MTN,Mauritania,1,0,0,0,0
59MTN,2016 Summer Olympics,59,MTN,Mauritania,1,0,0,0,0
54MTN,2012 Summer Olympics,54,MTN,Mauritania,2,0,0,0,0
53MTN,2008 Summer Olympics,53,MTN,Mauritania,2,0,0,0,0
26MTN,2004 Summer Olympics,26,MTN,Mauritania,2,0,0,0,0
25MTN,2000 Summer Olympics,25,MTN,Mauritania,2,0,0,0,0
24MTN,1996 Summer Olympics,24,MTN,Mauritania,1,0,0,0,0
23MTN,1992 Summer Olympics,23,MTN,Mauritania,5,0,0,0,0
22MTN,1988 Summer Olympics,22,MTN,Mauritania,5,0,0,0,0
21MTN,1984 Summer Olympics,21,MTN,Mauritania,2,0,0,0,0
62MAD,2022 Winter Olympics,62,MAD,Madagascar,1,0,0,0,0
61MAD,2020 Summer Olympics,61,MAD,Madagascar,6,0,0,0,0
60MAD,2018 Winter Olympics,60,MAD,Madagascar,1,0,0,0,0
59MAD,2016 Summer Olympics,59,MAD,Madagascar,3,0,0,0,0
54MAD,2012 Summer Olympics,54,MAD,Madagascar,7,0,0,0,0
53MAD,2008 Summer Olympics,53,MAD,Madagascar,4,0,0,0,0
49MAD,2006 Winter Olympics,49,MAD,Madagascar,1,0,0,0,0
26MAD,2004 Summer Olympics,26,MAD,Madagascar,4,0,0,0,0
25MAD,2000 Summer Olympics,25,MAD,Madagascar,9,0,0,0,0
24MAD,1996 Summer Olympics,24,MAD,Madagascar,6,0,0,0,0
23MAD,1992 Summer Olympics,23,MAD,Madagascar,13,0,0,0,0
21MAD,1984 Summer Olympics,21,MAD,Madagascar,3,0,0,0,0
20MAD,1980 Summer Olympics,20,MAD,Madagascar,11,0,0,0,0
18MAD,1972 Summer Olympics,18,MAD,Madagascar,11,0,0,0,0
17MAD,1968 Summer Olympics,17,MAD,Madagascar,3,0,0,0,0
16MAD,1964 Summer Olympics,16,MAD,Madagascar,3,0,0,0,0
61MDV,2020 Summer Olympics,61,MDV,Maldives,3,0,0,0,0
59MDV,2016 Summer Olympics,59,MDV,Maldives,2,0,0,0,0
54MDV,2012 Summer Olympics,54,MDV,Maldives,5,0,0,0,0
53MDV,2008 Summer Olympics,53,MDV,Maldives,3,0,0,0,0
26MDV,2004 Summer Olympics,26,MDV,Maldives,3,0,0,0,0
25MDV,2000 Summer Olympics,25,MDV,Maldives,3,0,0,0,0
24MDV,1996 Summer Olympics,24,MDV,Maldives,3,0,0,0,0
23MDV,1992 Summer Olympics,23,MDV,Maldives,5,0,0,0,0
22MDV,1988 Summer Olympics,22,MDV,Maldives,7,0,0,0,0
62IND,2022 Winter Olympics,62,IND,India,1,0,0,0,0
61IND,2020 Summer Olympics,61,IND,India,86,1,2,21,24
60IND,2018 Winter Olympics,60,IND,India,1,0,0,0,0
59IND,2016 Summer Olympics,59,IND,India,83,0,1,1,2
58IND,2014 Winter Olympics,58,IND,India,2,0,0,0,0
54IND,2012 Summer Olympics,54,IND,India,63,0,2,4,6
57IND,2010 Winter Olympics,57,IND,India,2,0,0,0,0
53IND,2008 Summer Olympics,53,IND,India,33,1,0,2,3
49IND,2006 Winter Olympics,49,IND,India,3,0,0,0,0
26IND,2004 Summer Olympics,26,IND,India,54,0,1,0,1
47IND,2002 Winter Olympics,47,IND,India,0,0,0,0,0
25IND,2000 Summer Olympics,25,IND,India,52,0,0,1,1
46IND,1998 Winter Olympics,46,IND,India,0,0,0,0,0
24IND,1996 Summer Olympics,24,IND,India,32,0,0,1,1
44IND,1992 Winter Olympics,44,IND,India,2,0,0,0,0
23IND,1992 Summer Olympics,23,IND,India,42,0,0,0,0
43IND,1988 Winter Olympics,43,IND,India,3,0,0,0,0
22IND,1988 Summer Olympics,22,IND,India,39,0,0,0,0
21IND,1984 Summer Olympics,21,IND,India,36,0,0,0,0
20IND,1980 Summer Olympics,20,IND,India,65,16,0,0,16
19IND,1976 Summer Olympics,19,IND,India,15,0,0,0,0
18IND,1972 Summer Olympics,18,IND,India,38,0,0,18,18
38IND,1968 Winter Olympics,38,IND,India,0,0,0,0,0
17IND,1968 Summer Olympics,17,IND,India,15,0,0,17,17
37IND,1964 Winter Olympics,37,IND,India,1,0,0,0,0
16IND,1964 Summer Olympics,16,IND,India,38,18,0,0,18
15IND,1960 Summer Olympics,15,IND,India,50,0,21,0,21
14IND,1956 Summer Olympics,14,IND,India,46,18,0,0,18
13IND,1952 Summer Olympics,13,IND,India,59,18,0,1,19
12IND,1948 Summer Olympics,12,IND,India,88,20,0,0,20
11IND,1936 Summer Olympics,11,IND,India,24,22,0,0,22
10IND,1932 Summer Olympics,10,IND,India,15,15,0,0,15
9IND,1928 Summer Olympics,9,IND,India,21,15,0,0,15
29IND,1924 Winter Olympics,29,IND,India,21,21,0,0,21
8IND,1924 Summer Olympics,8,IND,India,17,0,0,0,0
7IND,1920 Summer Olympics,7,IND,India,6,0,0,0,0
2IND,1900 Summer Olympics,2,IND,India,1,0,2,0,2
61MAW,2020 Summer Olympics,61,MAW,Malawi,4,0,0,0,0
59MAW,2016 Summer Olympics,59,MAW,Malawi,5,0,0,0,0
54MAW,2012 Summer Olympics,54,MAW,Malawi,3,0,0,0,0
53MAW,2008 Summer Olympics,53,MAW,Malawi,4,0,0,0,0
26MAW,2004 Summer Olympics,26,MAW,Malawi,3,0,0,0,0
25MAW,2000 Summer Olympics,25,MAW,Malawi,1,0,0,0,0
24MAW,1996 Summer Olympics,24,MAW,Malawi,1,0,0,0,0
23MAW,1992 Summer Olympics,23,MAW,Malawi,3,0,0,0,0
22MAW,1988 Summer Olympics,22,MAW,Malawi,9,0,0,0,0
21MAW,1984 Summer Olympics,21,MAW,Malawi,14,0,0,0,0
18MAW,1972 Summer Olympics,18,MAW,Malawi,16,0,0,0,0
61MHL,2020 Summer Olympics,61,MHL,Marshall Islands,1,0,0,0,0
59MHL,2016 Summer Olympics,59,MHL,Marshall Islands,4,0,0,0,0
54MHL,2012 Summer Olympics,54,MHL,Marshall Islands,3,0,0,0,0
53MHL,2008 Summer Olympics,53,MHL,Marshall Islands,5,0,0,0,0
62IRL,2022 Winter Olympics,62,IRL,Ireland,2,0,0,0,0
61IRL,2020 Summer Olympics,61,IRL,Ireland,96,3,0,5,8
60IRL,2018 Winter Olympics,60,IRL,Ireland,4,0,0,0,0
59IRL,2016 Summer Olympics,59,IRL,Ireland,59,0,3,0,3
58IRL,2014 Winter Olympics,58,IRL,Ireland,5,0,0,0,0
54IRL,2012 Summer Olympics,54,IRL,Ireland,40,1,1,4,6
57IRL,2010 Winter Olympics,57,IRL,Ireland,5,0,0,0,0
53IRL,2008 Summer Olympics,53,IRL,Ireland,39,0,1,2,3
49IRL,2006 Winter Olympics,49,IRL,Ireland,4,0,0,0,0
26IRL,2004 Summer Olympics,26,IRL,Ireland,25,0,0,0,0
47IRL,2002 Winter Olympics,47,IRL,Ireland,4,0,0,0,0
25IRL,2000 Summer Olympics,25,IRL,Ireland,47,0,1,0,1
46IRL,1998 Winter Olympics,46,IRL,Ireland,5,0,0,0,0
24IRL,1996 Summer Olympics,24,IRL,Ireland,56,3,0,1,4
44IRL,1992 Winter Olympics,44,IRL,Ireland,2,0,0,0,0
23IRL,1992 Summer Olympics,23,IRL,Ireland,38,1,1,0,2
22IRL,1988 Summer Olympics,22,IRL,Ireland,44,0,0,0,0
21IRL,1984 Summer Olympics,21,IRL,Ireland,34,0,1,0,1
20IRL,1980 Summer Olympics,20,IRL,Ireland,37,0,2,1,3
19IRL,1976 Summer Olympics,19,IRL,Ireland,35,0,0,0,0
18IRL,1972 Summer Olympics,18,IRL,Ireland,50,0,0,0,0
17IRL,1968 Summer Olympics,17,IRL,Ireland,26,0,0,0,0
16IRL,1964 Summer Olympics,16,IRL,Ireland,18,0,0,1,1
15IRL,1960 Summer Olympics,15,IRL,Ireland,36,0,0,0,0
48IRL,1956 Equestrian Olympics,48,IRL,Ireland,4,0,0,0,0
14IRL,1956 Summer Olympics,14,IRL,Ireland,13,1,1,3,5
13IRL,1952 Summer Olympics,13,IRL,Ireland,33,0,1,0,1
12IRL,1948 Summer Olympics,12,IRL,Ireland,104,0,0,1,1
10IRL,1932 Summer Olympics,10,IRL,Ireland,14,2,0,0,2
9IRL,1928 Summer Olympics,9,IRL,Ireland,28,1,0,0,1
8IRL,1924 Summer Olympics,8,IRL,Ireland,64,0,1,1,2
62KAZ,2022 Winter Olympics,62,KAZ,Kazakhstan,19,0,0,0,0
61KAZ,2020 Summer Olympics,61,KAZ,Kazakhstan,59,0,0,8,8
60KAZ,2018 Winter Olympics,60,KAZ,Kazakhstan,25,0,0,1,1
59KAZ,2016 Summer Olympics,59,KAZ,Kazakhstan,69,2,5,10,17
58KAZ,2014 Winter Olympics,58,KAZ,Kazakhstan,26,0,0,1,1
54KAZ,2012 Summer Olympics,54,KAZ,Kazakhstan,85,3,1,7,11
57KAZ,2010 Winter Olympics,57,KAZ,Kazakhstan,20,0,1,0,1
53KAZ,2008 Summer Olympics,53,KAZ,Kazakhstan,96,2,3,4,9
49KAZ,2006 Winter Olympics,49,KAZ,Kazakhstan,39,0,0,0,0
26KAZ,2004 Summer Olympics,26,KAZ,Kazakhstan,70,1,4,3,8
47KAZ,2002 Winter Olympics,47,KAZ,Kazakhstan,36,0,0,0,0
25KAZ,2000 Summer Olympics,25,KAZ,Kazakhstan,84,3,4,0,7
46KAZ,1998 Winter Olympics,46,KAZ,Kazakhstan,43,0,0,2,2
24KAZ,1996 Summer Olympics,24,KAZ,Kazakhstan,96,3,4,4,11
45KAZ,1994 Winter Olympics,45,KAZ,Kazakhstan,29,1,2,0,3
15MAL,1960 Summer Olympics,15,MAL,Malaya,8,0,0,0,0
14MAL,1956 Summer Olympics,14,MAL,Malaya,33,0,0,0,0
61KEN,2020 Summer Olympics,61,KEN,Kenya,69,4,4,2,10
60KEN,2018 Winter Olympics,60,KEN,Kenya,1,0,0,0,0
59KEN,2016 Summer Olympics,59,KEN,Kenya,63,6,6,1,13
54KEN,2012 Summer Olympics,54,KEN,Kenya,34,2,4,7,13
53KEN,2008 Summer Olympics,53,KEN,Kenya,35,6,4,6,16
49KEN,2006 Winter Olympics,49,KEN,Kenya,0,0,0,0,0
26KEN,2004 Summer Olympics,26,KEN,Kenya,33,1,4,2,7
47KEN,2002 Winter Olympics,47,KEN,Kenya,0,0,0,0,0
25KEN,2000 Summer Olympics,25,KEN,Kenya,41,2,3,2,7
46KEN,1998 Winter Olympics,46,KEN,Kenya,1,0,0,0,0
24KEN,1996 Summer Olympics,24,KEN,Kenya,41,1,4,3,8
23KEN,1992 Summer Olympics,23,KEN,Kenya,31,2,4,2,8
22KEN,1988 Summer Olympics,22,KEN,Kenya,59,5,2,2,9
21KEN,1984 Summer Olympics,21,KEN,Kenya,59,1,0,2,3
18KEN,1972 Summer Olympics,18,KEN,Kenya,33,7,3,4,14
17KEN,1968 Summer Olympics,17,KEN,Kenya,23,3,8,2,13
16KEN,1964 Summer Olympics,16,KEN,Kenya,24,0,0,1,1
15KEN,1960 Summer Olympics,15,KEN,Kenya,19,0,0,0,0
14KEN,1956 Summer Olympics,14,KEN,Kenya,27,0,0,0,0
61LBR,2020 Summer Olympics,61,LBR,Liberia,2,0,0,0,0
59LBR,2016 Summer Olympics,59,LBR,Liberia,2,0,0,0,0
54LBR,2012 Summer Olympics,54,LBR,Liberia,3,0,0,0,0
53LBR,2008 Summer Olympics,53,LBR,Liberia,3,0,0,0,0
26LBR,2004 Summer Olympics,26,LBR,Liberia,2,0,0,0,0
25LBR,2000 Summer Olympics,25,LBR,Liberia,5,0,0,0,0
24LBR,1996 Summer Olympics,24,LBR,Liberia,4,0,0,0,0
22LBR,1988 Summer Olympics,22,LBR,Liberia,6,0,0,0,0
21LBR,1984 Summer Olympics,21,LBR,Liberia,7,0,0,0,0
18LBR,1972 Summer Olympics,18,LBR,Liberia,6,0,0,0,0
16LBR,1964 Summer Olympics,16,LBR,Liberia,1,0,0,0,0
15LBR,1960 Summer Olympics,15,LBR,Liberia,2,0,0,0,0
14LBR,1956 Summer Olympics,14,LBR,Liberia,5,0,0,0,0
61LBA,2020 Summer Olympics,61,LBA,Libya,3,0,0,0,0
59LBA,2016 Summer Olympics,59,LBA,Libya,7,0,0,0,0
54LBA,2012 Summer Olympics,54,LBA,Libya,2,0,0,0,0
53LBA,2008 Summer Olympics,53,LBA,Libya,4,0,0,0,0
26LBA,2004 Summer Olympics,26,LBA,Libya,7,0,0,0,0
25LBA,2000 Summer Olympics,25,LBA,Libya,2,0,0,0,0
24LBA,1996 Summer Olympics,24,LBA,Libya,5,0,0,0,0
23LBA,1992 Summer Olympics,23,LBA,Libya,5,0,0,0,0
22LBA,1988 Summer Olympics,22,LBA,Libya,6,0,0,0,0
20LBA,1980 Summer Olympics,20,LBA,Libya,32,0,0,0,0
17LBA,1968 Summer Olympics,17,LBA,Libya,1,0,0,0,0
61LES,2020 Summer Olympics,61,LES,Lesotho,2,0,0,0,0
59LES,2016 Summer Olympics,59,LES,Lesotho,6,0,0,0,0
54LES,2012 Summer Olympics,54,LES,Lesotho,3,0,0,0,0
53LES,2008 Summer Olympics,53,LES,Lesotho,5,0,0,0,0
26LES,2004 Summer Olympics,26,LES,Lesotho,3,0,0,0,0
25LES,2000 Summer Olympics,25,LES,Lesotho,4,0,0,0,0
24LES,1996 Summer Olympics,24,LES,Lesotho,9,0,0,0,0
23LES,1992 Summer Olympics,23,LES,Lesotho,6,0,0,0,0
22LES,1988 Summer Olympics,22,LES,Lesotho,6,0,0,0,0
21LES,1984 Summer Olympics,21,LES,Lesotho,3,0,0,0,0
20LES,1980 Summer Olympics,20,LES,Lesotho,5,0,0,0,0
18LES,1972 Summer Olympics,18,LES,Lesotho,1,0,0,0,0
62JAM,2022 Winter Olympics,62,JAM,Jamaica,6,0,0,0,0
61JAM,2020 Summer Olympics,61,JAM,Jamaica,36,9,1,11,21
60JAM,2018 Winter Olympics,60,JAM,Jamaica,3,0,0,0,0
59JAM,2016 Summer Olympics,59,JAM,Jamaica,39,11,17,2,30
58JAM,2014 Winter Olympics,58,JAM,Jamaica,1,0,0,0,0
54JAM,2012 Summer Olympics,54,JAM,Jamaica,25,8,15,4,27
57JAM,2010 Winter Olympics,57,JAM,Jamaica,1,0,0,0,0
53JAM,2008 Summer Olympics,53,JAM,Jamaica,30,5,9,2,16
26JAM,2004 Summer Olympics,26,JAM,Jamaica,30,8,1,7,16
47JAM,2002 Winter Olympics,47,JAM,Jamaica,1,0,0,0,0
25JAM,2000 Summer Olympics,25,JAM,Jamaica,32,0,20,3,23
46JAM,1998 Winter Olympics,46,JAM,Jamaica,1,0,0,0,0
24JAM,1996 Summer Olympics,24,JAM,Jamaica,29,1,3,12,16
45JAM,1994 Winter Olympics,45,JAM,Jamaica,2,0,0,0,0
44JAM,1992 Winter Olympics,44,JAM,Jamaica,1,0,0,0,0
23JAM,1992 Summer Olympics,23,JAM,Jamaica,24,0,3,1,4
43JAM,1988 Winter Olympics,43,JAM,Jamaica,4,0,0,0,0
22JAM,1988 Summer Olympics,22,JAM,Jamaica,20,0,7,0,7
21JAM,1984 Summer Olympics,21,JAM,Jamaica,36,0,7,2,9
20JAM,1980 Summer Olympics,20,JAM,Jamaica,14,0,0,3,3
19JAM,1976 Summer Olympics,19,JAM,Jamaica,9,1,1,0,2
18JAM,1972 Summer Olympics,18,JAM,Jamaica,30,0,0,1,1
17JAM,1968 Summer Olympics,17,JAM,Jamaica,22,0,1,0,1
16JAM,1964 Summer Olympics,16,JAM,Jamaica,18,0,0,0,0
14JAM,1956 Summer Olympics,14,JAM,Jamaica,6,0,0,0,0
13JAM,1952 Summer Olympics,13,JAM,Jamaica,3,6,3,0,9
12JAM,1948 Summer Olympics,12,JAM,Jamaica,14,1,2,0,3
62KGZ,2022 Winter Olympics,62,KGZ,Kyrgyzstan,1,0,0,0,0
61KGZ,2020 Summer Olympics,61,KGZ,Kyrgyzstan,12,0,2,1,3
60KGZ,2018 Winter Olympics,60,KGZ,Kyrgyzstan,1,0,0,0,0
59KGZ,2016 Summer Olympics,59,KGZ,Kyrgyzstan,12,0,0,0,0
58KGZ,2014 Winter Olympics,58,KGZ,Kyrgyzstan,1,0,0,0,0
54KGZ,2012 Summer Olympics,54,KGZ,Kyrgyzstan,10,0,0,0,0
57KGZ,2010 Winter Olympics,57,KGZ,Kyrgyzstan,2,0,0,0,0
53KGZ,2008 Summer Olympics,53,KGZ,Kyrgyzstan,11,0,1,2,3
49KGZ,2006 Winter Olympics,49,KGZ,Kyrgyzstan,1,0,0,0,0
26KGZ,2004 Summer Olympics,26,KGZ,Kyrgyzstan,21,0,0,0,0
47KGZ,2002 Winter Olympics,47,KGZ,Kyrgyzstan,1,0,0,0,0
25KGZ,2000 Summer Olympics,25,KGZ,Kyrgyzstan,34,0,0,1,1
46KGZ,1998 Winter Olympics,46,KGZ,Kyrgyzstan,1,0,0,0,0
24KGZ,1996 Summer Olympics,24,KGZ,Kyrgyzstan,33,0,0,0,0
45KGZ,1994 Winter Olympics,45,KGZ,Kyrgyzstan,1,0,0,0,0
61KUW,2020 Summer Olympics,61,KUW,Kuwait,6,0,0,1,1
54KUW,2012 Summer Olympics,54,KUW,Kuwait,4,0,0,1,1
53KUW,2008 Summer Olympics,53,KUW,Kuwait,4,0,0,0,0
26KUW,2004 Summer Olympics,26,KUW,Kuwait,6,0,0,0,0
25KUW,2000 Summer Olympics,25,KUW,Kuwait,27,0,0,1,1
24KUW,1996 Summer Olympics,24,KUW,Kuwait,24,0,0,0,0
23KUW,1992 Summer Olympics,23,KUW,Kuwait,28,0,0,0,0
22KUW,1988 Summer Olympics,22,KUW,Kuwait,20,0,0,0,0
21KUW,1984 Summer Olympics,21,KUW,Kuwait,19,0,0,0,0
20KUW,1980 Summer Olympics,20,KUW,Kuwait,55,0,0,0,0
19KUW,1976 Summer Olympics,19,KUW,Kuwait,14,0,0,0,0
18KUW,1972 Summer Olympics,18,KUW,Kuwait,6,0,0,0,0
17KUW,1968 Summer Olympics,17,KUW,Kuwait,2,0,0,0,0
62IRI,2022 Winter Olympics,62,IRI,Islamic Republic of Iran,2,0,0,0,0
61IRI,2020 Summer Olympics,61,IRI,Islamic Republic of Iran,48,3,2,2,7
60IRI,2018 Winter Olympics,60,IRI,Islamic Republic of Iran,1,0,0,0,0
59IRI,2016 Summer Olympics,59,IRI,Islamic Republic of Iran,39,3,1,4,8
58IRI,2014 Winter Olympics,58,IRI,Islamic Republic of Iran,3,0,0,0,0
54IRI,2012 Summer Olympics,54,IRI,Islamic Republic of Iran,40,7,5,1,13
57IRI,2010 Winter Olympics,57,IRI,Islamic Republic of Iran,4,0,0,0,0
53IRI,2008 Summer Olympics,53,IRI,Islamic Republic of Iran,48,1,0,1,2
49IRI,2006 Winter Olympics,49,IRI,Islamic Republic of Iran,2,0,0,0,0
26IRI,2004 Summer Olympics,26,IRI,Islamic Republic of Iran,25,2,2,2,6
47IRI,2002 Winter Olympics,47,IRI,Islamic Republic of Iran,2,0,0,0,0
25IRI,2000 Summer Olympics,25,IRI,Islamic Republic of Iran,30,3,0,1,4
46IRI,1998 Winter Olympics,46,IRI,Islamic Republic of Iran,1,0,0,0,0
24IRI,1996 Summer Olympics,24,IRI,Islamic Republic of Iran,13,1,1,1,3
23IRI,1992 Summer Olympics,23,IRI,Islamic Republic of Iran,32,0,1,2,3
22IRI,1988 Summer Olympics,22,IRI,Islamic Republic of Iran,27,0,1,0,1
40IRI,1976 Winter Olympics,40,IRI,Islamic Republic of Iran,3,0,0,0,0
19IRI,1976 Summer Olympics,19,IRI,Islamic Republic of Iran,73,0,1,1,2
39IRI,1972 Winter Olympics,39,IRI,Islamic Republic of Iran,1,0,0,0,0
18IRI,1972 Summer Olympics,18,IRI,Islamic Republic of Iran,42,0,2,1,3
38IRI,1968 Winter Olympics,38,IRI,Islamic Republic of Iran,1,0,0,0,0
17IRI,1968 Summer Olympics,17,IRI,Islamic Republic of Iran,10,2,1,2,5
37IRI,1964 Winter Olympics,37,IRI,Islamic Republic of Iran,4,0,0,0,0
16IRI,1964 Summer Olympics,16,IRI,Islamic Republic of Iran,57,0,0,2,2
15IRI,1960 Summer Olympics,15,IRI,Islamic Republic of Iran,19,0,1,3,4
35IRI,1956 Winter Olympics,35,IRI,Islamic Republic of Iran,3,0,0,0,0
14IRI,1956 Summer Olympics,14,IRI,Islamic Republic of Iran,8,2,2,1,5
13IRI,1952 Summer Olympics,13,IRI,Islamic Republic of Iran,21,0,3,4,7
12IRI,1948 Summer Olympics,12,IRI,Islamic Republic of Iran,36,0,0,1,1
2IRI,1900 Summer Olympics,2,IRI,Islamic Republic of Iran,1,0,0,0,0
61LAO,2020 Summer Olympics,61,LAO,Lao People's Democratic Republic,1,0,0,0,0
59LAO,2016 Summer Olympics,59,LAO,Lao People's Democratic Republic,5,0,0,0,0
54LAO,2012 Summer Olympics,54,LAO,Lao People's Democratic Republic,3,0,0,0,0
53LAO,2008 Summer Olympics,53,LAO,Lao People's Democratic Republic,2,0,0,0,0
26LAO,2004 Summer Olympics,26,LAO,Lao People's Democratic Republic,5,0,0,0,0
25LAO,2000 Summer Olympics,25,LAO,Lao People's Democratic Republic,1,0,0,0,0
24LAO,1996 Summer Olympics,24,LAO,Lao People's Democratic Republic,5,0,0,0,0
23LAO,1992 Summer Olympics,23,LAO,Lao People's Democratic Republic,5,0,0,0,0
22LAO,1988 Summer Olympics,22,LAO,Lao People's Democratic Republic,3,0,0,0,0
20LAO,1980 Summer Olympics,20,LAO,Lao People's Democratic Republic,19,0,0,0,0
62AUT,2022 Winter Olympics,62,AUT,Austria,46,15,10,5,30
61AUT,2020 Summer Olympics,61,AUT,Austria,52,1,1,5,7
60AUT,2018 Winter Olympics,60,AUT,Austria,52,5,9,12,26
59AUT,2016 Summer Olympics,59,AUT,Austria,44,0,0,2,2
58AUT,2014 Winter Olympics,58,AUT,Austria,72,4,12,11,27
54AUT,2012 Summer Olympics,54,AUT,Austria,30,0,0,0,0
57AUT,2010 Winter Olympics,57,AUT,Austria,38,11,9,6,26
53AUT,2008 Summer Olympics,53,AUT,Austria,38,0,1,2,3
49AUT,2006 Winter Olympics,49,AUT,Austria,35,16,7,7,30
26AUT,2004 Summer Olympics,26,AUT,Austria,40,3,4,1,8
47AUT,2002 Winter Olympics,47,AUT,Austria,41,3,4,13,20
25AUT,2000 Summer Olympics,25,AUT,Austria,60,3,1,0,4
46AUT,1998 Winter Olympics,46,AUT,Austria,52,3,5,12,20
24AUT,1996 Summer Olympics,24,AUT,Austria,45,0,1,2,3
45AUT,1994 Winter Olympics,45,AUT,Austria,42,2,3,7,12
44AUT,1992 Winter Olympics,44,AUT,Austria,34,9,10,10,29
23AUT,1992 Summer Olympics,23,AUT,Austria,78,0,6,0,6
43AUT,1988 Winter Olympics,43,AUT,Austria,57,3,5,4,12
22AUT,1988 Summer Olympics,22,AUT,Austria,64,1,0,0,1
42AUT,1984 Winter Olympics,42,AUT,Austria,51,0,0,1,1
21AUT,1984 Summer Olympics,21,AUT,Austria,78,1,1,1,3
41AUT,1980 Winter Olympics,41,AUT,Austria,27,3,2,3,8
20AUT,1980 Summer Olympics,20,AUT,Austria,70,1,3,1,5
40AUT,1976 Winter Olympics,40,AUT,Austria,59,2,2,3,7
19AUT,1976 Summer Olympics,19,AUT,Austria,35,0,0,1,1
39AUT,1972 Winter Olympics,39,AUT,Austria,23,1,2,2,5
18AUT,1972 Summer Olympics,18,AUT,Austria,87,0,1,2,3
38AUT,1968 Winter Olympics,38,AUT,Austria,48,3,8,4,15
17AUT,1968 Summer Olympics,17,AUT,Austria,22,0,2,3,5
37AUT,1964 Winter Olympics,37,AUT,Austria,94,5,9,3,17
16AUT,1964 Summer Olympics,16,AUT,Austria,34,0,0,0,0
36AUT,1960 Winter Olympics,36,AUT,Austria,17,1,2,3,6
15AUT,1960 Summer Olympics,15,AUT,Austria,94,1,2,0,3
48AUT,1956 Equestrian Olympics,48,AUT,Austria,5,0,0,0,0
35AUT,1956 Winter Olympics,35,AUT,Austria,43,5,3,4,12
14AUT,1956 Summer Olympics,14,AUT,Austria,14,0,0,4,4
34AUT,1952 Winter Olympics,34,AUT,Austria,29,2,4,2,8
13AUT,1952 Summer Olympics,13,AUT,Austria,102,0,1,2,3
33AUT,1948 Winter Olympics,33,AUT,Austria,49,1,3,4,8
62ISR,2022 Winter Olympics,62,ISR,Israel,3,0,0,0,0
61ISR,2020 Summer Olympics,61,ISR,Israel,75,2,0,12,14
60ISR,2018 Winter Olympics,60,ISR,Israel,7,0,0,0,0
59ISR,2016 Summer Olympics,59,ISR,Israel,34,0,0,2,2
58ISR,2014 Winter Olympics,58,ISR,Israel,5,0,0,0,0
54ISR,2012 Summer Olympics,54,ISR,Israel,21,0,0,0,0
57ISR,2010 Winter Olympics,57,ISR,Israel,0,0,0,0,0
53ISR,2008 Summer Olympics,53,ISR,Israel,28,0,0,1,1
49ISR,2006 Winter Olympics,49,ISR,Israel,3,0,0,0,0
26ISR,2004 Summer Olympics,26,ISR,Israel,24,1,0,1,2
47ISR,2002 Winter Olympics,47,ISR,Israel,3,0,0,0,0
12AUT,1948 Summer Olympics,12,AUT,Austria,146,2,2,4,8
25ISR,2000 Summer Olympics,25,ISR,Israel,27,0,0,1,1
46ISR,1998 Winter Olympics,46,ISR,Israel,2,0,0,0,0
24ISR,1996 Summer Olympics,24,ISR,Israel,19,0,0,1,1
45ISR,1994 Winter Olympics,45,ISR,Israel,1,0,0,0,0
23ISR,1992 Summer Olympics,23,ISR,Israel,26,0,1,1,2
22ISR,1988 Summer Olympics,22,ISR,Israel,13,0,0,0,0
32AUT,1936 Winter Olympics,32,AUT,Austria,77,1,2,2,5
11AUT,1936 Summer Olympics,11,AUT,Austria,241,6,49,6,61
31AUT,1932 Winter Olympics,31,AUT,Austria,2,1,1,0,2
21ISR,1984 Summer Olympics,21,ISR,Israel,31,0,0,0,0
19ISR,1976 Summer Olympics,19,ISR,Israel,26,0,0,0,0
10AUT,1932 Summer Olympics,10,AUT,Austria,14,1,1,3,5
30AUT,1928 Winter Olympics,30,AUT,Austria,37,0,4,2,6
9AUT,1928 Summer Olympics,9,AUT,Austria,69,3,0,2,5
29AUT,1924 Winter Olympics,29,AUT,Austria,4,3,1,0,4
8AUT,1924 Summer Olympics,8,AUT,Austria,79,0,3,1,4
6AUT,1912 Summer Olympics,6,AUT,Austria,103,0,10,5,15
18ISR,1972 Summer Olympics,18,ISR,Israel,10,0,0,0,0
17ISR,1968 Summer Olympics,17,ISR,Israel,28,0,0,0,0
16ISR,1964 Summer Olympics,16,ISR,Israel,7,0,0,0,0
5AUT,1908 Summer Olympics,5,AUT,Austria,19,0,0,1,1
2AUT,1900 Summer Olympics,2,AUT,Austria,20,0,3,3,6
1AUT,1896 Summer Olympics,1,AUT,Austria,3,2,1,2,5
15ISR,1960 Summer Olympics,15,ISR,Israel,22,0,0,0,0
14ISR,1956 Summer Olympics,14,ISR,Israel,2,0,0,0,0
13ISR,1952 Summer Olympics,13,ISR,Israel,27,0,0,0,0
62DEN,2022 Winter Olympics,62,DEN,Denmark,57,0,0,0,0
61DEN,2020 Summer Olympics,61,DEN,Denmark,71,4,23,5,32
60DEN,2018 Winter Olympics,60,DEN,Denmark,10,0,0,0,0
59DEN,2016 Summer Olympics,59,DEN,Denmark,73,15,10,16,41
58DEN,2014 Winter Olympics,58,DEN,Denmark,7,0,0,0,0
54DEN,2012 Summer Olympics,54,DEN,Denmark,74,3,5,8,16
57DEN,2010 Winter Olympics,57,DEN,Denmark,15,0,0,0,0
53DEN,2008 Summer Olympics,53,DEN,Denmark,61,6,7,6,19
49DEN,2006 Winter Olympics,49,DEN,Denmark,3,0,0,0,0
26DEN,2004 Summer Olympics,26,DEN,Denmark,52,19,1,9,29
47DEN,2002 Winter Olympics,47,DEN,Denmark,7,0,0,0,0
25DEN,2000 Summer Olympics,25,DEN,Denmark,56,18,3,4,25
46DEN,1998 Winter Olympics,46,DEN,Denmark,8,0,5,0,5
24DEN,1996 Summer Olympics,24,DEN,Denmark,87,22,1,1,24
45DEN,1994 Winter Olympics,45,DEN,Denmark,2,0,0,0,0
44DEN,1992 Winter Olympics,44,DEN,Denmark,9,0,0,0,0
23DEN,1992 Summer Olympics,23,DEN,Denmark,89,3,2,9,14
43DEN,1988 Winter Olympics,43,DEN,Denmark,11,0,0,0,0
22DEN,1988 Summer Olympics,22,DEN,Denmark,72,3,1,3,7
21DEN,1984 Summer Olympics,21,DEN,Denmark,46,0,3,10,13
20DEN,1980 Summer Olympics,20,DEN,Denmark,39,4,2,2,8
19DEN,1976 Summer Olympics,19,DEN,Denmark,42,3,0,5,8
18DEN,1972 Summer Olympics,18,DEN,Denmark,110,1,0,0,1
38DEN,1968 Winter Olympics,38,DEN,Denmark,2,0,0,0,0
17DEN,1968 Summer Olympics,17,DEN,Denmark,47,5,6,6,17
37DEN,1964 Winter Olympics,37,DEN,Denmark,1,0,0,0,0
16DEN,1964 Summer Olympics,16,DEN,Denmark,44,7,1,4,12
36DEN,1960 Winter Olympics,36,DEN,Denmark,1,0,0,0,0
15DEN,1960 Summer Olympics,15,DEN,Denmark,99,2,24,4,30
48DEN,1956 Equestrian Olympics,48,DEN,Denmark,4,0,1,0,1
14DEN,1956 Summer Olympics,14,DEN,Denmark,18,1,3,1,5
34DEN,1952 Winter Olympics,34,DEN,Denmark,0,0,0,0,0
13DEN,1952 Summer Olympics,13,DEN,Denmark,113,3,1,5,9
33DEN,1948 Winter Olympics,33,DEN,Denmark,2,0,0,0,0
12DEN,1948 Summer Olympics,12,DEN,Denmark,158,7,18,36,61
11DEN,1936 Summer Olympics,11,DEN,Denmark,115,0,3,3,6
10DEN,1932 Summer Olympics,10,DEN,Denmark,36,0,8,4,12
9DEN,1928 Summer Olympics,9,DEN,Denmark,69,6,5,4,15
8DEN,1924 Summer Olympics,8,DEN,Denmark,71,2,9,3,14
7DEN,1920 Summer Olympics,7,DEN,Denmark,149,26,46,1,73
6DEN,1912 Summer Olympics,6,DEN,Denmark,135,5,54,33,92
5DEN,1908 Summer Olympics,5,DEN,Denmark,82,0,18,3,21
2DEN,1900 Summer Olympics,2,DEN,Denmark,13,7,3,2,12
1DEN,1896 Summer Olympics,1,DEN,Denmark,4,1,2,3,6
62KSA,2022 Winter Olympics,62,KSA,Kingdom of Saudi Arabia,1,0,0,0,0
61KSA,2020 Summer Olympics,61,KSA,Kingdom of Saudi Arabia,31,0,1,0,1
59KSA,2016 Summer Olympics,59,KSA,Kingdom of Saudi Arabia,8,0,0,0,0
54KSA,2012 Summer Olympics,54,KSA,Kingdom of Saudi Arabia,11,0,0,4,4
53KSA,2008 Summer Olympics,53,KSA,Kingdom of Saudi Arabia,9,0,0,0,0
26KSA,2004 Summer Olympics,26,KSA,Kingdom of Saudi Arabia,7,0,0,0,0
25KSA,2000 Summer Olympics,25,KSA,Kingdom of Saudi Arabia,10,0,1,1,2
24KSA,1996 Summer Olympics,24,KSA,Kingdom of Saudi Arabia,35,0,0,0,0
23KSA,1992 Summer Olympics,23,KSA,Kingdom of Saudi Arabia,8,0,0,0,0
22KSA,1988 Summer Olympics,22,KSA,Kingdom of Saudi Arabia,14,0,0,0,0
21KSA,1984 Summer Olympics,21,KSA,Kingdom of Saudi Arabia,41,0,0,0,0
19KSA,1976 Summer Olympics,19,KSA,Kingdom of Saudi Arabia,17,0,0,0,0
18KSA,1972 Summer Olympics,18,KSA,Kingdom of Saudi Arabia,12,0,0,0,0
62ISL,2022 Winter Olympics,62,ISL,Iceland,2,0,0,0,0
61ISL,2020 Summer Olympics,61,ISL,Iceland,1,0,0,0,0
60ISL,2018 Winter Olympics,60,ISL,Iceland,5,0,0,0,0
59ISL,2016 Summer Olympics,59,ISL,Iceland,3,0,0,0,0
58ISL,2014 Winter Olympics,58,ISL,Iceland,5,0,0,0,0
54ISL,2012 Summer Olympics,54,ISL,Iceland,11,0,0,0,0
57ISL,2010 Winter Olympics,57,ISL,Iceland,3,0,0,0,0
53ISL,2008 Summer Olympics,53,ISL,Iceland,16,0,14,0,14
49ISL,2006 Winter Olympics,49,ISL,Iceland,3,0,0,0,0
26ISL,2004 Summer Olympics,26,ISL,Iceland,16,0,0,0,0
47ISL,2002 Winter Olympics,47,ISL,Iceland,5,0,0,0,0
25ISL,2000 Summer Olympics,25,ISL,Iceland,13,0,0,1,1
46ISL,1998 Winter Olympics,46,ISL,Iceland,6,0,0,0,0
24ISL,1996 Summer Olympics,24,ISL,Iceland,7,0,0,0,0
45ISL,1994 Winter Olympics,45,ISL,Iceland,2,0,0,0,0
44ISL,1992 Winter Olympics,44,ISL,Iceland,5,0,0,0,0
23ISL,1992 Summer Olympics,23,ISL,Iceland,19,0,0,0,0
43ISL,1988 Winter Olympics,43,ISL,Iceland,2,0,0,0,0
22ISL,1988 Summer Olympics,22,ISL,Iceland,16,0,0,0,0
42ISL,1984 Winter Olympics,42,ISL,Iceland,5,0,0,0,0
21ISL,1984 Summer Olympics,21,ISL,Iceland,27,0,0,1,1
41ISL,1980 Winter Olympics,41,ISL,Iceland,4,0,0,0,0
20ISL,1980 Summer Olympics,20,ISL,Iceland,7,0,0,0,0
40ISL,1976 Winter Olympics,40,ISL,Iceland,8,0,0,0,0
19ISL,1976 Summer Olympics,19,ISL,Iceland,11,0,0,0,0
18ISL,1972 Summer Olympics,18,ISL,Iceland,24,0,0,0,0
38ISL,1968 Winter Olympics,38,ISL,Iceland,3,0,0,0,0
17ISL,1968 Summer Olympics,17,ISL,Iceland,4,0,0,0,0
37ISL,1964 Winter Olympics,37,ISL,Iceland,3,0,0,0,0
16ISL,1964 Summer Olympics,16,ISL,Iceland,2,0,0,0,0
36ISL,1960 Winter Olympics,36,ISL,Iceland,3,0,0,0,0
15ISL,1960 Summer Olympics,15,ISL,Iceland,7,0,0,0,0
35ISL,1956 Winter Olympics,35,ISL,Iceland,5,0,0,0,0
14ISL,1956 Summer Olympics,14,ISL,Iceland,2,0,1,0,1
34ISL,1952 Winter Olympics,34,ISL,Iceland,10,0,0,0,0
13ISL,1952 Summer Olympics,13,ISL,Iceland,8,0,0,0,0
33ISL,1948 Winter Olympics,33,ISL,Iceland,4,0,0,0,0
12ISL,1948 Summer Olympics,12,ISL,Iceland,23,0,0,0,0
11ISL,1936 Summer Olympics,11,ISL,Iceland,15,0,0,0,0
6ISL,1912 Summer Olympics,6,ISL,Iceland,5,0,0,0,0
5ISL,1908 Summer Olympics,5,ISL,Iceland,5,0,0,0,0
62KOS,2022 Winter Olympics,62,KOS,Kosovo,1,0,0,0,0
61KOS,2020 Summer Olympics,61,KOS,Kosovo,8,2,0,0,2
60KOS,2018 Winter Olympics,60,KOS,Kosovo,1,0,0,0,0
59KOS,2016 Summer Olympics,59,KOS,Kosovo,7,1,0,0,1
61KIR,2020 Summer Olympics,61,KIR,Kiribati,3,0,0,0,0
59KIR,2016 Summer Olympics,59,KIR,Kiribati,2,0,0,0,0
54KIR,2012 Summer Olympics,54,KIR,Kiribati,2,0,0,0,0
53KIR,2008 Summer Olympics,53,KIR,Kiribati,2,0,0,0,0
26KIR,2004 Summer Olympics,26,KIR,Kiribati,3,0,0,0,0
44TCH,1992 Winter Olympics,44,TCH,Czechoslovakia,27,0,0,28,28
23TCH,1992 Summer Olympics,23,TCH,Czechoslovakia,121,4,3,1,8
43TCH,1988 Winter Olympics,43,TCH,Czechoslovakia,32,0,1,5,6
22TCH,1988 Summer Olympics,22,TCH,Czechoslovakia,137,3,4,3,10
42TCH,1984 Winter Olympics,42,TCH,Czechoslovakia,29,0,24,4,28
41TCH,1980 Winter Olympics,41,TCH,Czechoslovakia,24,0,0,1,1
20TCH,1980 Summer Olympics,20,TCH,Czechoslovakia,158,18,18,16,52
40TCH,1976 Winter Olympics,40,TCH,Czechoslovakia,42,0,19,0,19
19TCH,1976 Summer Olympics,19,TCH,Czechoslovakia,98,2,4,9,15
39TCH,1972 Winter Olympics,39,TCH,Czechoslovakia,26,1,0,22,23
18TCH,1972 Summer Olympics,18,TCH,Czechoslovakia,141,2,21,6,29
38TCH,1968 Winter Olympics,38,TCH,Czechoslovakia,35,1,19,1,21
17TCH,1968 Summer Olympics,17,TCH,Czechoslovakia,94,7,7,15,29
37TCH,1964 Winter Olympics,37,TCH,Czechoslovakia,35,0,0,17,17
16TCH,1964 Summer Olympics,16,TCH,Czechoslovakia,77,5,38,12,55
36TCH,1960 Winter Olympics,36,TCH,Czechoslovakia,13,0,1,0,1
15TCH,1960 Summer Olympics,15,TCH,Czechoslovakia,93,4,7,11,22
35TCH,1956 Winter Olympics,35,TCH,Czechoslovakia,32,0,0,0,0
14TCH,1956 Summer Olympics,14,TCH,Czechoslovakia,36,1,5,1,7
34TCH,1952 Winter Olympics,34,TCH,Czechoslovakia,19,0,0,0,0
13TCH,1952 Summer Olympics,13,TCH,Czechoslovakia,78,11,4,10,25
33TCH,1948 Winter Olympics,33,TCH,Czechoslovakia,50,0,17,0,17
12TCH,1948 Summer Olympics,12,TCH,Czechoslovakia,82,14,3,3,20
32TCH,1936 Winter Olympics,32,TCH,Czechoslovakia,51,0,0,0,0
11TCH,1936 Summer Olympics,11,TCH,Czechoslovakia,183,5,12,1,18
31TCH,1932 Winter Olympics,31,TCH,Czechoslovakia,5,0,0,0,0
10TCH,1932 Summer Olympics,10,TCH,Czechoslovakia,20,1,3,2,6
30TCH,1928 Winter Olympics,30,TCH,Czechoslovakia,28,0,0,1,1
9TCH,1928 Summer Olympics,9,TCH,Czechoslovakia,51,2,12,2,16
29TCH,1924 Winter Olympics,29,TCH,Czechoslovakia,26,0,0,0,0
8TCH,1924 Summer Olympics,8,TCH,Czechoslovakia,143,1,4,5,10
7TCH,1920 Summer Olympics,7,TCH,Czechoslovakia,117,0,0,11,11
60COR,2018 Winter Olympics,60,COR,Korea Team,35,0,0,0,0
62BRA,2022 Winter Olympics,62,BRA,Brazil,5,0,0,0,0
61BRA,2020 Summer Olympics,61,BRA,Brazil,186,29,17,9,55
60BRA,2018 Winter Olympics,60,BRA,Brazil,3,0,0,0,0
59BRA,2016 Summer Olympics,59,BRA,Brazil,321,42,8,6,56
58BRA,2014 Winter Olympics,58,BRA,Brazil,7,0,0,0,0
54BRA,2012 Summer Olympics,54,BRA,Brazil,136,14,38,11,63
57BRA,2010 Winter Olympics,57,BRA,Brazil,3,0,0,0,0
53BRA,2008 Summer Olympics,53,BRA,Brazil,163,14,34,38,86
49BRA,2006 Winter Olympics,49,BRA,Brazil,3,0,0,0,0
26BRA,2004 Summer Olympics,26,BRA,Brazil,140,18,21,3,42
47BRA,2002 Winter Olympics,47,BRA,Brazil,10,0,0,0,0
25BRA,2000 Summer Olympics,25,BRA,Brazil,147,0,12,36,48
46BRA,1998 Winter Olympics,46,BRA,Brazil,0,0,0,0,0
24BRA,1996 Summer Olympics,24,BRA,Brazil,151,5,15,48,68
45BRA,1994 Winter Olympics,45,BRA,Brazil,0,0,0,0,0
44BRA,1992 Winter Olympics,44,BRA,Brazil,7,0,0,0,0
23BRA,1992 Summer Olympics,23,BRA,Brazil,135,13,1,0,14
22BRA,1988 Summer Olympics,22,BRA,Brazil,118,1,21,5,27
21BRA,1984 Summer Olympics,21,BRA,Brazil,96,1,34,2,37
20BRA,1980 Summer Olympics,20,BRA,Brazil,86,4,0,5,9
19BRA,1976 Summer Olympics,19,BRA,Brazil,63,0,0,3,3
18BRA,1972 Summer Olympics,18,BRA,Brazil,64,0,0,2,2
17BRA,1968 Summer Olympics,17,BRA,Brazil,59,0,1,3,4
16BRA,1964 Summer Olympics,16,BRA,Brazil,53,0,0,12,12
15BRA,1960 Summer Olympics,15,BRA,Brazil,57,0,0,13,13
48BRA,1956 Equestrian Olympics,48,BRA,Brazil,1,0,0,0,0
14BRA,1956 Summer Olympics,14,BRA,Brazil,28,1,0,0,1
13BRA,1952 Summer Olympics,13,BRA,Brazil,84,1,0,2,3
12BRA,1948 Summer Olympics,12,BRA,Brazil,69,0,0,12,12
11BRA,1936 Summer Olympics,11,BRA,Brazil,67,0,0,0,0
10BRA,1932 Summer Olympics,10,BRA,Brazil,76,0,0,0,0
8BRA,1924 Summer Olympics,8,BRA,Brazil,14,0,0,0,0
7BRA,1920 Summer Olympics,7,BRA,Brazil,19,1,1,5,7
62HKG,2022 Winter Olympics,62,HKG,"Hong Kong, China",3,0,0,0,0
61HKG,2020 Summer Olympics,61,HKG,"Hong Kong, China",27,1,2,5,8
60HKG,2018 Winter Olympics,60,HKG,"Hong Kong, China",1,0,0,0,0
59HKG,2016 Summer Olympics,59,HKG,"Hong Kong, China",25,0,0,0,0
58HKG,2014 Winter Olympics,58,HKG,"Hong Kong, China",1,0,0,0,0
54HKG,2012 Summer Olympics,54,HKG,"Hong Kong, China",29,0,0,1,1
57HKG,2010 Winter Olympics,57,HKG,"Hong Kong, China",0,0,0,0,0
53HKG,2008 Summer Olympics,53,HKG,"Hong Kong, China",23,0,0,0,0
49HKG,2006 Winter Olympics,49,HKG,"Hong Kong, China",1,0,0,0,0
26HKG,2004 Summer Olympics,26,HKG,"Hong Kong, China",19,0,2,0,2
47HKG,2002 Winter Olympics,47,HKG,"Hong Kong, China",2,0,0,0,0
25HKG,2000 Summer Olympics,25,HKG,"Hong Kong, China",26,0,0,0,0
24HKG,1996 Summer Olympics,24,HKG,"Hong Kong, China",14,1,0,0,1
23HKG,1992 Summer Olympics,23,HKG,"Hong Kong, China",29,0,0,0,0
22HKG,1988 Summer Olympics,22,HKG,"Hong Kong, China",40,0,0,0,0
21HKG,1984 Summer Olympics,21,HKG,"Hong Kong, China",43,0,0,0,0
19HKG,1976 Summer Olympics,19,HKG,"Hong Kong, China",20,0,0,0,0
18HKG,1972 Summer Olympics,18,HKG,"Hong Kong, China",8,0,0,0,0
17HKG,1968 Summer Olympics,17,HKG,"Hong Kong, China",6,0,0,0,0
16HKG,1964 Summer Olympics,16,HKG,"Hong Kong, China",36,0,0,0,0
15HKG,1960 Summer Olympics,15,HKG,"Hong Kong, China",3,0,0,0,0
14HKG,1956 Summer Olympics,14,HKG,"Hong Kong, China",1,0,0,0,0
13HKG,1952 Summer Olympics,13,HKG,"Hong Kong, China",4,0,0,0,0
61INA,2020 Summer Olympics,61,INA,Indonesia,21,2,1,3,6
59INA,2016 Summer Olympics,59,INA,Indonesia,18,2,2,0,4
54INA,2012 Summer Olympics,54,INA,Indonesia,16,0,2,1,3
53INA,2008 Summer Olympics,53,INA,Indonesia,17,2,2,4,8
26INA,2004 Summer Olympics,26,INA,Indonesia,28,1,1,3,5
25INA,2000 Summer Olympics,25,INA,Indonesia,31,2,4,2,8
24INA,1996 Summer Olympics,24,INA,Indonesia,27,2,1,3,6
23INA,1992 Summer Olympics,23,INA,Indonesia,41,2,3,1,6
22INA,1988 Summer Olympics,22,INA,Indonesia,30,0,3,0,3
21INA,1984 Summer Olympics,21,INA,Indonesia,16,0,0,0,0
19INA,1976 Summer Olympics,19,INA,Indonesia,6,0,0,0,0
18INA,1972 Summer Olympics,18,INA,Indonesia,9,0,0,0,0
17INA,1968 Summer Olympics,17,INA,Indonesia,6,0,0,0,0
15INA,1960 Summer Olympics,15,INA,Indonesia,23,0,0,0,0
14INA,1956 Summer Olympics,14,INA,Indonesia,29,0,0,0,0
13INA,1952 Summer Olympics,13,INA,Indonesia,4,0,0,0,0
61JOR,2020 Summer Olympics,61,JOR,Jordan,10,0,1,1,2
59JOR,2016 Summer Olympics,59,JOR,Jordan,6,1,0,0,1
54JOR,2012 Summer Olympics,54,JOR,Jordan,7,0,0,0,0
53JOR,2008 Summer Olympics,53,JOR,Jordan,3,0,0,0,0
26JOR,2004 Summer Olympics,26,JOR,Jordan,7,0,0,0,0
25JOR,2000 Summer Olympics,25,JOR,Jordan,7,0,0,0,0
24JOR,1996 Summer Olympics,24,JOR,Jordan,4,0,0,0,0
23JOR,1992 Summer Olympics,23,JOR,Jordan,7,0,0,0,0
22JOR,1988 Summer Olympics,22,JOR,Jordan,9,0,0,0,0
21JOR,1984 Summer Olympics,21,JOR,Jordan,12,0,0,0,0
20JOR,1980 Summer Olympics,20,JOR,Jordan,4,0,0,0,0
61IRQ,2020 Summer Olympics,61,IRQ,Iraq,2,0,0,0,0
59IRQ,2016 Summer Olympics,59,IRQ,Iraq,26,0,0,0,0
54IRQ,2012 Summer Olympics,54,IRQ,Iraq,7,0,0,0,0
53IRQ,2008 Summer Olympics,53,IRQ,Iraq,4,0,0,0,0
26IRQ,2004 Summer Olympics,26,IRQ,Iraq,27,0,0,0,0
25IRQ,2000 Summer Olympics,25,IRQ,Iraq,4,0,0,0,0
24IRQ,1996 Summer Olympics,24,IRQ,Iraq,2,0,0,0,0
23IRQ,1992 Summer Olympics,23,IRQ,Iraq,8,0,0,0,0
22IRQ,1988 Summer Olympics,22,IRQ,Iraq,27,0,0,0,0
21IRQ,1984 Summer Olympics,21,IRQ,Iraq,17,0,0,0,0
20IRQ,1980 Summer Olympics,20,IRQ,Iraq,44,0,0,0,0
17IRQ,1968 Summer Olympics,17,IRQ,Iraq,2,0,0,0,0
16IRQ,1964 Summer Olympics,16,IRQ,Iraq,12,0,0,0,0
15IRQ,1960 Summer Olympics,15,IRQ,Iraq,21,0,0,1,1
12IRQ,1948 Summer Olympics,12,IRQ,Iraq,11,0,0,0,0
62BEL,2022 Winter Olympics,62,BEL,Belgium,10,1,0,1,2
61BEL,2020 Summer Olympics,61,BEL,Belgium,81,20,1,6,27
60BEL,2018 Winter Olympics,60,BEL,Belgium,16,0,1,0,1
59BEL,2016 Summer Olympics,59,BEL,Belgium,63,2,19,2,23
58BEL,2014 Winter Olympics,58,BEL,Belgium,5,0,0,0,0
54BEL,2012 Summer Olympics,54,BEL,Belgium,79,0,1,2,3
57BEL,2010 Winter Olympics,57,BEL,Belgium,6,0,0,0,0
53BEL,2008 Summer Olympics,53,BEL,Belgium,81,7,0,0,7
49BEL,2006 Winter Olympics,49,BEL,Belgium,0,0,0,0,0
26BEL,2004 Summer Olympics,26,BEL,Belgium,33,1,0,2,3
47BEL,2002 Winter Olympics,47,BEL,Belgium,5,0,0,0,0
25BEL,2000 Summer Olympics,25,BEL,Belgium,41,0,3,4,7
46BEL,1998 Winter Olympics,46,BEL,Belgium,1,0,0,1,1
24BEL,1996 Summer Olympics,24,BEL,Belgium,35,2,2,2,6
45BEL,1994 Winter Olympics,45,BEL,Belgium,2,0,0,0,0
44BEL,1992 Winter Olympics,44,BEL,Belgium,5,0,0,0,0
23BEL,1992 Summer Olympics,23,BEL,Belgium,43,0,1,2,3
43BEL,1988 Winter Olympics,43,BEL,Belgium,3,0,0,0,0
22BEL,1988 Summer Olympics,22,BEL,Belgium,45,0,0,2,2
42BEL,1984 Winter Olympics,42,BEL,Belgium,3,0,0,0,0
21BEL,1984 Summer Olympics,21,BEL,Belgium,52,1,2,2,5
41BEL,1980 Winter Olympics,41,BEL,Belgium,2,0,0,0,0
20BEL,1980 Summer Olympics,20,BEL,Belgium,36,1,0,0,1
40BEL,1976 Winter Olympics,40,BEL,Belgium,3,0,0,0,0
19BEL,1976 Summer Olympics,19,BEL,Belgium,75,0,3,6,9
39BEL,1972 Winter Olympics,39,BEL,Belgium,1,0,0,0,0
18BEL,1972 Summer Olympics,18,BEL,Belgium,66,0,2,0,2
17BEL,1968 Summer Olympics,17,BEL,Belgium,70,0,1,2,3
37BEL,1964 Winter Olympics,37,BEL,Belgium,7,0,0,0,0
16BEL,1964 Summer Olympics,16,BEL,Belgium,29,2,0,1,3
15BEL,1960 Summer Olympics,15,BEL,Belgium,78,0,2,2,4
48BEL,1956 Equestrian Olympics,48,BEL,Belgium,3,0,0,0,0
35BEL,1956 Winter Olympics,35,BEL,Belgium,0,0,0,0,0
14BEL,1956 Summer Olympics,14,BEL,Belgium,35,0,2,0,2
34BEL,1952 Winter Olympics,34,BEL,Belgium,5,0,0,0,0
13BEL,1952 Summer Olympics,13,BEL,Belgium,104,5,3,0,8
33BEL,1948 Winter Olympics,33,BEL,Belgium,10,2,4,0,6
12BEL,1948 Summer Olympics,12,BEL,Belgium,151,5,2,8,15
32BEL,1936 Winter Olympics,32,BEL,Belgium,19,0,0,0,0
11BEL,1936 Summer Olympics,11,BEL,Belgium,146,0,0,16,16
31BEL,1932 Winter Olympics,31,BEL,Belgium,3,0,0,0,0
10BEL,1932 Summer Olympics,10,BEL,Belgium,31,0,0,1,1
30BEL,1928 Winter Olympics,30,BEL,Belgium,20,0,0,1,1
9BEL,1928 Summer Olympics,9,BEL,Belgium,169,0,1,5,6
29BEL,1924 Winter Olympics,29,BEL,Belgium,20,0,0,5,5
8BEL,1924 Summer Olympics,8,BEL,Belgium,131,3,34,6,43
7BEL,1920 Summer Olympics,7,BEL,Belgium,328,65,65,68,198
6BEL,1912 Summer Olympics,6,BEL,Belgium,26,9,1,11,21
5BEL,1908 Summer Olympics,5,BEL,Belgium,75,1,29,8,38
2BEL,1900 Summer Olympics,2,BEL,Belgium,98,6,23,16,45
62ARG,2022 Winter Olympics,62,ARG,Argentina,5,0,0,0,0
61ARG,2020 Summer Olympics,61,ARG,Argentina,118,0,18,25,43
60ARG,2018 Winter Olympics,60,ARG,Argentina,5,0,0,0,0
59ARG,2016 Summer Olympics,59,ARG,Argentina,150,21,1,0,22
58ARG,2014 Winter Olympics,58,ARG,Argentina,5,0,0,0,0
54ARG,2012 Summer Olympics,54,ARG,Argentina,94,1,18,3,22
57ARG,2010 Winter Olympics,57,ARG,Argentina,3,0,0,0,0
53ARG,2008 Summer Olympics,53,ARG,Argentina,89,21,0,33,54
49ARG,2006 Winter Olympics,49,ARG,Argentina,5,0,0,0,0
26ARG,2004 Summer Olympics,26,ARG,Argentina,84,34,0,21,55
47ARG,2002 Winter Olympics,47,ARG,Argentina,10,0,0,0,0
25ARG,2000 Summer Olympics,25,ARG,Argentina,92,0,17,3,20
46ARG,1998 Winter Olympics,46,ARG,Argentina,1,0,0,0,0
24ARG,1996 Summer Olympics,24,ARG,Argentina,149,0,23,1,24
45ARG,1994 Winter Olympics,45,ARG,Argentina,7,0,0,0,0
44ARG,1992 Winter Olympics,44,ARG,Argentina,15,0,0,0,0
23ARG,1992 Summer Olympics,23,ARG,Argentina,81,0,0,2,2
43ARG,1988 Winter Olympics,43,ARG,Argentina,12,0,0,0,0
22ARG,1988 Summer Olympics,22,ARG,Argentina,98,0,1,12,13
42ARG,1984 Winter Olympics,42,ARG,Argentina,17,0,0,0,0
21ARG,1984 Summer Olympics,21,ARG,Argentina,79,0,0,0,0
41ARG,1980 Winter Olympics,41,ARG,Argentina,10,0,0,0,0
40ARG,1976 Winter Olympics,40,ARG,Argentina,8,0,0,0,0
19ARG,1976 Summer Olympics,19,ARG,Argentina,48,0,0,0,0
39ARG,1972 Winter Olympics,39,ARG,Argentina,1,0,0,0,0
18ARG,1972 Summer Olympics,18,ARG,Argentina,67,0,1,0,1
38ARG,1968 Winter Olympics,38,ARG,Argentina,6,0,0,0,0
17ARG,1968 Summer Olympics,17,ARG,Argentina,73,0,0,2,2
37ARG,1964 Winter Olympics,37,ARG,Argentina,6,0,0,0,0
16ARG,1964 Summer Olympics,16,ARG,Argentina,86,0,1,0,1
36ARG,1960 Winter Olympics,36,ARG,Argentina,6,0,0,0,0
15ARG,1960 Summer Olympics,15,ARG,Argentina,81,0,3,1,4
48ARG,1956 Equestrian Olympics,48,ARG,Argentina,7,0,0,0,0
14ARG,1956 Summer Olympics,14,ARG,Argentina,22,0,1,1,2
34ARG,1952 Winter Olympics,34,ARG,Argentina,8,0,0,0,0
13ARG,1952 Summer Olympics,13,ARG,Argentina,79,2,2,2,6
33ARG,1948 Winter Olympics,33,ARG,Argentina,9,0,0,0,0
12ARG,1948 Summer Olympics,12,ARG,Argentina,208,3,8,1,12
11ARG,1936 Summer Olympics,11,ARG,Argentina,38,5,2,4,11
10ARG,1932 Summer Olympics,10,ARG,Argentina,27,3,1,0,4
30ARG,1928 Winter Olympics,30,ARG,Argentina,10,0,0,0,0
9ARG,1928 Summer Olympics,9,ARG,Argentina,84,3,24,5,32
8ARG,1924 Summer Olympics,8,ARG,Argentina,83,6,3,2,11
7ARG,1920 Summer Olympics,7,ARG,Argentina,1,0,0,0,0
5ARG,1908 Summer Olympics,5,ARG,Argentina,1,0,0,0,0
2ARG,1900 Summer Olympics,2,ARG,Argentina,3,0,0,0,0
61HON,2020 Summer Olympics,61,HON,Honduras,27,0,0,0,0
59HON,2016 Summer Olympics,59,HON,Honduras,23,0,0,0,0
54HON,2012 Summer Olympics,54,HON,Honduras,30,0,0,0,0
53HON,2008 Summer Olympics,53,HON,Honduras,26,0,0,0,0
26HON,2004 Summer Olympics,26,HON,Honduras,5,0,0,0,0
25HON,2000 Summer Olympics,25,HON,Honduras,24,0,0,0,0
24HON,1996 Summer Olympics,24,HON,Honduras,6,0,0,0,0
44HON,1992 Winter Olympics,44,HON,Honduras,1,0,0,0,0
23HON,1992 Summer Olympics,23,HON,Honduras,7,0,0,0,0
22HON,1988 Summer Olympics,22,HON,Honduras,7,0,0,0,0
21HON,1984 Summer Olympics,21,HON,Honduras,9,0,0,0,0
19HON,1976 Summer Olympics,19,HON,Honduras,3,0,0,0,0
17HON,1968 Summer Olympics,17,HON,Honduras,6,0,0,0,0
62HAI,2022 Winter Olympics,62,HAI,Haiti,1,0,0,0,0
61HAI,2020 Summer Olympics,61,HAI,Haiti,5,0,0,0,0
59HAI,2016 Summer Olympics,59,HAI,Haiti,9,0,0,0,0
54HAI,2012 Summer Olympics,54,HAI,Haiti,4,0,0,0,0
53HAI,2008 Summer Olympics,53,HAI,Haiti,4,0,0,0,0
26HAI,2004 Summer Olympics,26,HAI,Haiti,5,0,0,0,0
25HAI,2000 Summer Olympics,25,HAI,Haiti,5,0,0,0,0
24HAI,1996 Summer Olympics,24,HAI,Haiti,6,0,0,0,0
23HAI,1992 Summer Olympics,23,HAI,Haiti,5,0,0,0,0
22HAI,1988 Summer Olympics,22,HAI,Haiti,2,0,0,0,0
21HAI,1984 Summer Olympics,21,HAI,Haiti,3,0,0,0,0
19HAI,1976 Summer Olympics,19,HAI,Haiti,13,0,0,0,0
18HAI,1972 Summer Olympics,18,HAI,Haiti,7,0,0,0,0
15HAI,1960 Summer Olympics,15,HAI,Haiti,1,0,0,0,0
10HAI,1932 Summer Olympics,10,HAI,Haiti,1,0,0,0,0
9HAI,1928 Summer Olympics,9,HAI,Haiti,0,0,1,0,1
8HAI,1924 Summer Olympics,8,HAI,Haiti,9,0,0,5,5
2HAI,1900 Summer Olympics,2,HAI,Haiti,2,0,0,0,0
61GUA,2020 Summer Olympics,61,GUA,Guatemala,15,0,0,0,0
59GUA,2016 Summer Olympics,59,GUA,Guatemala,12,0,0,0,0
54GUA,2012 Summer Olympics,54,GUA,Guatemala,14,0,1,0,1
53GUA,2008 Summer Olympics,53,GUA,Guatemala,7,0,0,0,0
26GUA,2004 Summer Olympics,26,GUA,Guatemala,12,0,0,0,0
25GUA,2000 Summer Olympics,25,GUA,Guatemala,9,0,0,0,0
24GUA,1996 Summer Olympics,24,GUA,Guatemala,22,0,0,0,0
23GUA,1992 Summer Olympics,23,GUA,Guatemala,12,0,0,0,0
43GUA,1988 Winter Olympics,43,GUA,Guatemala,6,0,0,0,0
22GUA,1988 Summer Olympics,22,GUA,Guatemala,25,0,0,0,0
21GUA,1984 Summer Olympics,21,GUA,Guatemala,17,0,0,0,0
20GUA,1980 Summer Olympics,20,GUA,Guatemala,6,0,0,0,0
19GUA,1976 Summer Olympics,19,GUA,Guatemala,26,0,0,0,0
18GUA,1972 Summer Olympics,18,GUA,Guatemala,5,0,0,0,0
17GUA,1968 Summer Olympics,17,GUA,Guatemala,47,0,0,0,0
13GUA,1952 Summer Olympics,13,GUA,Guatemala,24,0,0,0,0
10GUA,1932 Summer Olympics,10,GUA,Guatemala,1,0,0,0,0
61GUY,2020 Summer Olympics,61,GUY,Guyana,6,0,0,0,0
59GUY,2016 Summer Olympics,59,GUY,Guyana,5,0,0,0,0
54GUY,2012 Summer Olympics,54,GUY,Guyana,4,0,0,0,0
53GUY,2008 Summer Olympics,53,GUY,Guyana,2,0,0,0,0
26GUY,2004 Summer Olympics,26,GUY,Guyana,3,0,0,0,0
25GUY,2000 Summer Olympics,25,GUY,Guyana,3,0,0,0,0
24GUY,1996 Summer Olympics,24,GUY,Guyana,7,0,0,0,0
23GUY,1992 Summer Olympics,23,GUY,Guyana,5,0,0,0,0
22GUY,1988 Summer Olympics,22,GUY,Guyana,7,0,0,0,0
21GUY,1984 Summer Olympics,21,GUY,Guyana,8,0,0,0,0
20GUY,1980 Summer Olympics,20,GUY,Guyana,8,0,0,1,1
18GUY,1972 Summer Olympics,18,GUY,Guyana,3,0,0,0,0
17GUY,1968 Summer Olympics,17,GUY,Guyana,5,0,0,0,0
16GUY,1964 Summer Olympics,16,GUY,Guyana,1,0,0,0,0
15GUY,1960 Summer Olympics,15,GUY,Guyana,5,0,0,0,0
14GUY,1956 Summer Olympics,14,GUY,Guyana,4,0,0,0,0
13GUY,1952 Summer Olympics,13,GUY,Guyana,1,0,0,0,0
12GUY,1948 Summer Olympics,12,GUY,Guyana,4,0,0,0,0
59IOA,2016 Summer Olympics,59,IOA,Independent Olympic Athletes,9,1,0,1,2
58IOA,2014 Winter Olympics,58,IOA,Independent Olympic Athletes,1,0,0,0,0
54IOA,2012 Summer Olympics,54,IOA,Independent Olympic Athletes,3,0,0,0,0
25IOA,2000 Summer Olympics,25,IOA,Independent Olympic Athletes,4,0,0,0,0
23IOA,1992 Summer Olympics,23,IOA,Independent Olympic Athletes,58,0,1,2,3
61EGY,2020 Summer Olympics,61,EGY,Egypt,97,1,1,4,6
59EGY,2016 Summer Olympics,59,EGY,Egypt,92,0,0,3,3
54EGY,2012 Summer Olympics,54,EGY,Egypt,86,0,3,1,4
53EGY,2008 Summer Olympics,53,EGY,Egypt,76,0,0,2,2
26EGY,2004 Summer Olympics,26,EGY,Egypt,75,1,1,3,5
25EGY,2000 Summer Olympics,25,EGY,Egypt,71,0,0,0,0
24EGY,1996 Summer Olympics,24,EGY,Egypt,14,0,0,0,0
23EGY,1992 Summer Olympics,23,EGY,Egypt,67,0,0,0,0
22EGY,1988 Summer Olympics,22,EGY,Egypt,36,0,0,0,0
42EGY,1984 Winter Olympics,42,EGY,Egypt,1,0,0,0,0
21EGY,1984 Summer Olympics,21,EGY,Egypt,110,0,1,0,1
19EGY,1976 Summer Olympics,19,EGY,Egypt,25,0,0,0,0
18EGY,1972 Summer Olympics,18,EGY,Egypt,23,0,0,0,0
17EGY,1968 Summer Olympics,17,EGY,Egypt,20,0,0,0,0
16EGY,1964 Summer Olympics,16,EGY,Egypt,74,0,0,0,0
48EGY,1956 Equestrian Olympics,48,EGY,Egypt,1,0,0,0,0
13EGY,1952 Summer Olympics,13,EGY,Egypt,79,0,0,1,1
12EGY,1948 Summer Olympics,12,EGY,Egypt,95,2,2,1,5
11EGY,1936 Summer Olympics,11,EGY,Egypt,61,2,1,2,5
9EGY,1928 Summer Olympics,9,EGY,Egypt,26,2,1,1,4
8EGY,1924 Summer Olympics,8,EGY,Egypt,23,0,0,0,0
7EGY,1920 Summer Olympics,7,EGY,Egypt,23,0,0,0,0
62BUL,2022 Winter Olympics,62,BUL,Bulgaria,5,0,0,0,0
61BUL,2020 Summer Olympics,61,BUL,Bulgaria,25,7,1,2,10
60BUL,2018 Winter Olympics,60,BUL,Bulgaria,11,0,0,0,0
59BUL,2016 Summer Olympics,59,BUL,Bulgaria,35,0,1,6,7
58BUL,2014 Winter Olympics,58,BUL,Bulgaria,9,0,0,0,0
54BUL,2012 Summer Olympics,54,BUL,Bulgaria,44,0,2,1,3
57BUL,2010 Winter Olympics,57,BUL,Bulgaria,11,0,0,0,0
53BUL,2008 Summer Olympics,53,BUL,Bulgaria,42,1,1,3,5
49BUL,2006 Winter Olympics,49,BUL,Bulgaria,10,0,1,0,1
26BUL,2004 Summer Olympics,26,BUL,Bulgaria,51,2,1,14,17
47BUL,2002 Winter Olympics,47,BUL,Bulgaria,10,0,1,2,3
25BUL,2000 Summer Olympics,25,BUL,Bulgaria,64,5,6,2,13
46BUL,1998 Winter Olympics,46,BUL,Bulgaria,13,1,0,0,1
24BUL,1996 Summer Olympics,24,BUL,Bulgaria,63,3,12,6,21
45BUL,1994 Winter Olympics,45,BUL,Bulgaria,4,0,0,0,0
44BUL,1992 Winter Olympics,44,BUL,Bulgaria,21,0,0,0,0
23BUL,1992 Summer Olympics,23,BUL,Bulgaria,94,3,7,7,17
43BUL,1988 Winter Olympics,43,BUL,Bulgaria,21,0,0,0,0
22BUL,1988 Summer Olympics,22,BUL,Bulgaria,147,10,14,17,41
42BUL,1984 Winter Olympics,42,BUL,Bulgaria,11,0,0,0,0
41BUL,1980 Winter Olympics,41,BUL,Bulgaria,5,0,0,1,1
20BUL,1980 Summer Olympics,20,BUL,Bulgaria,212,8,44,40,92
40BUL,1976 Winter Olympics,40,BUL,Bulgaria,27,0,0,0,0
19BUL,1976 Summer Olympics,19,BUL,Bulgaria,126,8,13,18,39
39BUL,1972 Winter Olympics,39,BUL,Bulgaria,3,0,0,0,0
18BUL,1972 Summer Olympics,18,BUL,Bulgaria,109,6,10,6,22
38BUL,1968 Winter Olympics,38,BUL,Bulgaria,3,0,0,0,0
17BUL,1968 Summer Olympics,17,BUL,Bulgaria,99,2,22,3,27
37BUL,1964 Winter Olympics,37,BUL,Bulgaria,3,0,0,0,0
16BUL,1964 Summer Olympics,16,BUL,Bulgaria,41,3,5,2,10
36BUL,1960 Winter Olympics,36,BUL,Bulgaria,5,0,0,0,0
15BUL,1960 Summer Olympics,15,BUL,Bulgaria,78,1,3,3,7
48BUL,1956 Equestrian Olympics,48,BUL,Bulgaria,2,0,0,0,0
35BUL,1956 Winter Olympics,35,BUL,Bulgaria,5,0,0,0,0
14BUL,1956 Summer Olympics,14,BUL,Bulgaria,28,1,3,15,19
34BUL,1952 Winter Olympics,34,BUL,Bulgaria,8,0,0,0,0
13BUL,1952 Summer Olympics,13,BUL,Bulgaria,72,0,0,1,1
33BUL,1948 Winter Olympics,33,BUL,Bulgaria,4,0,0,0,0
32BUL,1936 Winter Olympics,32,BUL,Bulgaria,8,0,0,0,0
11BUL,1936 Summer Olympics,11,BUL,Bulgaria,26,0,0,0,0
10BUL,1932 Summer Olympics,10,BUL,Bulgaria,2,0,0,0,0
9BUL,1928 Summer Olympics,9,BUL,Bulgaria,3,0,0,0,0
8BUL,1924 Summer Olympics,8,BUL,Bulgaria,36,0,0,0,0
1BUL,1896 Summer Olympics,1,BUL,Bulgaria,1,0,0,0,0
43GDR,1988 Winter Olympics,43,GDR,East Germany,32,10,15,7,32
22GDR,1988 Summer Olympics,22,GDR,East Germany,234,79,56,50,185
42GDR,1984 Winter Olympics,42,GDR,East Germany,39,13,13,7,33
41GDR,1980 Winter Olympics,41,GDR,East Germany,34,16,11,12,39
20GDR,1980 Summer Olympics,20,GDR,East Germany,247,117,92,61,270
40GDR,1976 Winter Olympics,40,GDR,East Germany,45,12,6,14,32
19GDR,1976 Summer Olympics,19,GDR,East Germany,202,107,53,42,202
39GDR,1972 Winter Olympics,39,GDR,East Germany,25,5,3,12,20
18GDR,1972 Summer Olympics,18,GDR,East Germany,235,32,69,59,160
38GDR,1968 Winter Olympics,38,GDR,East Germany,57,2,2,2,6
17GDR,1968 Summer Olympics,17,GDR,East Germany,236,13,20,19,52
61GUI,2020 Summer Olympics,61,GUI,Guinea,5,0,0,0,0
59GUI,2016 Summer Olympics,59,GUI,Guinea,5,0,0,0,0
54GUI,2012 Summer Olympics,54,GUI,Guinea,4,0,0,0,0
53GUI,2008 Summer Olympics,53,GUI,Guinea,4,0,0,0,0
26GUI,2004 Summer Olympics,26,GUI,Guinea,3,0,0,0,0
25GUI,2000 Summer Olympics,25,GUI,Guinea,4,0,0,0,0
24GUI,1996 Summer Olympics,24,GUI,Guinea,3,0,0,0,0
23GUI,1992 Summer Olympics,23,GUI,Guinea,8,0,0,0,0
22GUI,1988 Summer Olympics,22,GUI,Guinea,5,0,0,0,0
21GUI,1984 Summer Olympics,21,GUI,Guinea,0,0,0,0,0
20GUI,1980 Summer Olympics,20,GUI,Guinea,9,0,0,0,0
17GUI,1968 Summer Olympics,17,GUI,Guinea,19,0,0,0,0
62GHA,2022 Winter Olympics,62,GHA,Ghana,1,0,0,0,0
61GHA,2020 Summer Olympics,61,GHA,Ghana,10,0,0,1,1
60GHA,2018 Winter Olympics,60,GHA,Ghana,1,0,0,0,0
59GHA,2016 Summer Olympics,59,GHA,Ghana,13,0,0,0,0
54GHA,2012 Summer Olympics,54,GHA,Ghana,6,0,0,0,0
57GHA,2010 Winter Olympics,57,GHA,Ghana,1,0,0,0,0
53GHA,2008 Summer Olympics,53,GHA,Ghana,7,0,0,0,0
26GHA,2004 Summer Olympics,26,GHA,Ghana,24,0,0,0,0
25GHA,2000 Summer Olympics,25,GHA,Ghana,15,0,0,0,0
24GHA,1996 Summer Olympics,24,GHA,Ghana,33,0,0,0,0
23GHA,1992 Summer Olympics,23,GHA,Ghana,29,0,0,20,20
22GHA,1988 Summer Olympics,22,GHA,Ghana,14,0,0,0,0
21GHA,1984 Summer Olympics,21,GHA,Ghana,26,0,0,0,0
18GHA,1972 Summer Olympics,18,GHA,Ghana,23,0,0,1,1
17GHA,1968 Summer Olympics,17,GHA,Ghana,28,0,0,0,0
16GHA,1964 Summer Olympics,16,GHA,Ghana,36,0,0,1,1
15GHA,1960 Summer Olympics,15,GHA,Ghana,15,0,1,0,1
13GHA,1952 Summer Olympics,13,GHA,Ghana,9,0,0,0,0
62EST,2022 Winter Olympics,62,EST,Estonia,15,0,0,1,1
61EST,2020 Summer Olympics,61,EST,Estonia,11,4,0,1,5
60EST,2018 Winter Olympics,60,EST,Estonia,10,0,0,0,0
59EST,2016 Summer Olympics,59,EST,Estonia,26,0,0,4,4
58EST,2014 Winter Olympics,58,EST,Estonia,15,0,0,0,0
54EST,2012 Summer Olympics,54,EST,Estonia,16,0,1,1,2
57EST,2010 Winter Olympics,57,EST,Estonia,15,0,1,0,1
53EST,2008 Summer Olympics,53,EST,Estonia,30,1,2,0,3
49EST,2006 Winter Olympics,49,EST,Estonia,14,3,0,0,3
26EST,2004 Summer Olympics,26,EST,Estonia,24,0,1,2,3
47EST,2002 Winter Olympics,47,EST,Estonia,4,1,1,1,3
25EST,2000 Summer Olympics,25,EST,Estonia,13,1,0,2,3
46EST,1998 Winter Olympics,46,EST,Estonia,10,0,0,0,0
24EST,1996 Summer Olympics,24,EST,Estonia,23,0,0,0,0
45EST,1994 Winter Olympics,45,EST,Estonia,11,0,0,0,0
44EST,1992 Winter Olympics,44,EST,Estonia,20,0,0,0,0
23EST,1992 Summer Olympics,23,EST,Estonia,37,1,0,2,3
32EST,1936 Winter Olympics,32,EST,Estonia,4,0,0,0,0
11EST,1936 Summer Olympics,11,EST,Estonia,34,2,2,3,7
10EST,1932 Summer Olympics,10,EST,Estonia,1,0,0,0,0
30EST,1928 Winter Olympics,30,EST,Estonia,2,0,0,0,0
9EST,1928 Summer Olympics,9,EST,Estonia,18,2,1,6,9
8EST,1924 Summer Olympics,8,EST,Estonia,45,1,1,4,6
7EST,1920 Summer Olympics,7,EST,Estonia,14,1,2,0,3
61GBS,2020 Summer Olympics,61,GBS,Guinea Bissau,3,0,0,0,0
59GBS,2016 Summer Olympics,59,GBS,Guinea Bissau,3,0,0,0,0
54GBS,2012 Summer Olympics,54,GBS,Guinea Bissau,2,0,0,0,0
53GBS,2008 Summer Olympics,53,GBS,Guinea Bissau,3,0,0,0,0
26GBS,2004 Summer Olympics,26,GBS,Guinea Bissau,2,0,0,0,0
25GBS,2000 Summer Olympics,25,GBS,Guinea Bissau,2,0,0,0,0
24GBS,1996 Summer Olympics,24,GBS,Guinea Bissau,3,0,0,0,0
61CUB,2020 Summer Olympics,61,CUB,Cuba,32,8,3,5,16
59CUB,2016 Summer Olympics,59,CUB,Cuba,79,5,2,4,11
54CUB,2012 Summer Olympics,54,CUB,Cuba,61,5,3,7,15
53CUB,2008 Summer Olympics,53,CUB,Cuba,102,3,33,17,53
26CUB,2004 Summer Olympics,26,CUB,Cuba,90,32,8,22,62
25CUB,2000 Summer Olympics,25,CUB,Cuba,143,22,35,12,69
24CUB,1996 Summer Olympics,24,CUB,Cuba,86,39,8,10,57
23CUB,1992 Summer Olympics,23,CUB,Cuba,179,44,13,14,71
20CUB,1980 Summer Olympics,20,CUB,Cuba,139,8,7,5,20
19CUB,1976 Summer Olympics,19,CUB,Cuba,100,6,4,14,24
18CUB,1972 Summer Olympics,18,CUB,Cuba,98,3,1,18,22
17CUB,1968 Summer Olympics,17,CUB,Cuba,110,0,15,0,15
16CUB,1964 Summer Olympics,16,CUB,Cuba,26,0,1,0,1
15CUB,1960 Summer Olympics,15,CUB,Cuba,8,0,0,0,0
14CUB,1956 Summer Olympics,14,CUB,Cuba,12,0,0,0,0
13CUB,1952 Summer Olympics,13,CUB,Cuba,13,0,0,0,0
12CUB,1948 Summer Olympics,12,CUB,Cuba,55,0,2,0,2
10CUB,1932 Summer Olympics,10,CUB,Cuba,8,0,0,0,0
9CUB,1928 Summer Olympics,9,CUB,Cuba,1,0,0,0,0
8CUB,1924 Summer Olympics,8,CUB,Cuba,22,0,0,0,0
3CUB,1904 Summer Olympics,3,CUB,Cuba,3,6,0,0,6
2CUB,1900 Summer Olympics,2,CUB,Cuba,1,1,1,0,2
61GUM,2020 Summer Olympics,61,GUM,Guam,4,0,0,0,0
59GUM,2016 Summer Olympics,59,GUM,Guam,3,0,0,0,0
54GUM,2012 Summer Olympics,54,GUM,Guam,3,0,0,0,0
53GUM,2008 Summer Olympics,53,GUM,Guam,6,0,0,0,0
26GUM,2004 Summer Olympics,26,GUM,Guam,3,0,0,0,0
25GUM,2000 Summer Olympics,25,GUM,Guam,5,0,0,0,0
24GUM,1996 Summer Olympics,24,GUM,Guam,6,0,0,0,0
23GUM,1992 Summer Olympics,23,GUM,Guam,20,0,0,0,0
43GUM,1988 Winter Olympics,43,GUM,Guam,1,0,0,0,0
22GUM,1988 Summer Olympics,22,GUM,Guam,19,0,0,0,0
62GEO,2022 Winter Olympics,62,GEO,Georgia,7,0,0,0,0
61GEO,2020 Summer Olympics,61,GEO,Georgia,19,2,5,1,8
60GEO,2018 Winter Olympics,60,GEO,Georgia,2,0,0,0,0
59GEO,2016 Summer Olympics,59,GEO,Georgia,28,2,1,4,7
58GEO,2014 Winter Olympics,58,GEO,Georgia,1,0,0,0,0
54GEO,2012 Summer Olympics,54,GEO,Georgia,27,1,2,3,6
57GEO,2010 Winter Olympics,57,GEO,Georgia,5,0,0,0,0
53GEO,2008 Summer Olympics,53,GEO,Georgia,19,3,2,2,7
49GEO,2006 Winter Olympics,49,GEO,Georgia,2,0,0,0,0
26GEO,2004 Summer Olympics,26,GEO,Georgia,19,2,2,0,4
47GEO,2002 Winter Olympics,47,GEO,Georgia,2,0,0,0,0
25GEO,2000 Summer Olympics,25,GEO,Georgia,27,0,0,6,6
46GEO,1998 Winter Olympics,46,GEO,Georgia,1,0,0,0,0
24GEO,1996 Summer Olympics,24,GEO,Georgia,34,0,0,2,2
45GEO,1994 Winter Olympics,45,GEO,Georgia,5,0,0,0,0
61GRN,2020 Summer Olympics,61,GRN,Grenada,4,0,0,1,1
59GRN,2016 Summer Olympics,59,GRN,Grenada,4,0,1,0,1
54GRN,2012 Summer Olympics,54,GRN,Grenada,8,1,0,0,1
53GRN,2008 Summer Olympics,53,GRN,Grenada,7,0,0,0,0
26GRN,2004 Summer Olympics,26,GRN,Grenada,3,0,0,0,0
25GRN,2000 Summer Olympics,25,GRN,Grenada,3,0,0,0,0
24GRN,1996 Summer Olympics,24,GRN,Grenada,5,0,0,0,0
23GRN,1992 Summer Olympics,23,GRN,Grenada,4,0,0,0,0
22GRN,1988 Summer Olympics,22,GRN,Grenada,4,0,0,0,0
21GRN,1984 Summer Olympics,21,GRN,Grenada,7,0,0,0,0
62CZE,2022 Winter Olympics,62,CZE,Czechia,74,1,0,1,2
61CZE,2020 Summer Olympics,61,CZE,Czechia,73,5,4,4,13
60CZE,2018 Winter Olympics,60,CZE,Czechia,60,2,2,3,7
59CZE,2016 Summer Olympics,59,CZE,Czechia,40,1,2,12,15
58CZE,2014 Winter Olympics,58,CZE,Czechia,35,2,7,6,15
54CZE,2012 Summer Olympics,54,CZE,Czechia,73,4,5,6,15
57CZE,2010 Winter Olympics,57,CZE,Czechia,47,2,0,7,9
53CZE,2008 Summer Olympics,53,CZE,Czechia,70,3,4,1,8
49CZE,2006 Winter Olympics,49,CZE,Czechia,39,1,2,25,28
26CZE,2004 Summer Olympics,26,CZE,Czechia,88,1,6,6,13
47CZE,2002 Winter Olympics,47,CZE,Czechia,41,1,2,0,3
25CZE,2000 Summer Olympics,25,CZE,Czechia,89,2,3,4,9
46CZE,1998 Winter Olympics,46,CZE,Czechia,44,23,1,1,25
24CZE,1996 Summer Olympics,24,CZE,Czechia,114,4,5,4,13
45CZE,1994 Winter Olympics,45,CZE,Czechia,64,0,0,0,0
61FIJ,2020 Summer Olympics,61,FIJ,Fiji,25,13,0,13,26
59FIJ,2016 Summer Olympics,59,FIJ,Fiji,48,13,0,0,13
54FIJ,2012 Summer Olympics,54,FIJ,Fiji,7,0,0,0,0
53FIJ,2008 Summer Olympics,53,FIJ,Fiji,2,0,0,0,0
26FIJ,2004 Summer Olympics,26,FIJ,Fiji,6,0,0,0,0
47FIJ,2002 Winter Olympics,47,FIJ,Fiji,1,0,0,0,0
25FIJ,2000 Summer Olympics,25,FIJ,Fiji,1,0,0,0,0
24FIJ,1996 Summer Olympics,24,FIJ,Fiji,14,0,0,0,0
45FIJ,1994 Winter Olympics,45,FIJ,Fiji,0,0,0,0,0
23FIJ,1992 Summer Olympics,23,FIJ,Fiji,11,0,0,0,0
43FIJ,1988 Winter Olympics,43,FIJ,Fiji,1,0,0,0,0
22FIJ,1988 Summer Olympics,22,FIJ,Fiji,14,0,0,0,0
21FIJ,1984 Summer Olympics,21,FIJ,Fiji,14,0,0,0,0
19FIJ,1976 Summer Olympics,19,FIJ,Fiji,2,0,0,0,0
18FIJ,1972 Summer Olympics,18,FIJ,Fiji,2,0,0,0,0
17FIJ,1968 Summer Olympics,17,FIJ,Fiji,1,0,0,0,0
15FIJ,1960 Summer Olympics,15,FIJ,Fiji,1,0,0,0,0
14FIJ,1956 Summer Olympics,14,FIJ,Fiji,5,0,0,0,0
61ETH,2020 Summer Olympics,61,ETH,Ethiopia,32,1,1,2,4
59ETH,2016 Summer Olympics,59,ETH,Ethiopia,25,1,2,5,8
54ETH,2012 Summer Olympics,54,ETH,Ethiopia,23,3,2,3,8
57ETH,2010 Winter Olympics,57,ETH,Ethiopia,0,0,0,0,0
53ETH,2008 Summer Olympics,53,ETH,Ethiopia,19,4,2,1,7
49ETH,2006 Winter Olympics,49,ETH,Ethiopia,1,0,0,0,0
26ETH,2004 Summer Olympics,26,ETH,Ethiopia,20,2,3,2,7
25ETH,2000 Summer Olympics,25,ETH,Ethiopia,18,4,1,3,8
24ETH,1996 Summer Olympics,24,ETH,Ethiopia,13,2,0,1,3
23ETH,1992 Summer Olympics,23,ETH,Ethiopia,20,1,0,2,3
20ETH,1980 Summer Olympics,20,ETH,Ethiopia,36,2,0,2,4
18ETH,1972 Summer Olympics,18,ETH,Ethiopia,25,0,0,2,2
17ETH,1968 Summer Olympics,17,ETH,Ethiopia,9,1,1,0,2
16ETH,1964 Summer Olympics,16,ETH,Ethiopia,10,1,0,0,1
15ETH,1960 Summer Olympics,15,ETH,Ethiopia,7,1,0,0,1
14ETH,1956 Summer Olympics,14,ETH,Ethiopia,13,0,0,0,0
62CHI,2022 Winter Olympics,62,CHI,Chile,1,0,0,0,0
61CHI,2020 Summer Olympics,61,CHI,Chile,45,0,0,0,0
60CHI,2018 Winter Olympics,60,CHI,Chile,2,0,0,0,0
59CHI,2016 Summer Olympics,59,CHI,Chile,27,0,0,0,0
58CHI,2014 Winter Olympics,58,CHI,Chile,5,0,0,0,0
54CHI,2012 Summer Olympics,54,CHI,Chile,21,0,0,0,0
57CHI,2010 Winter Olympics,57,CHI,Chile,0,0,0,0,0
53CHI,2008 Summer Olympics,53,CHI,Chile,15,0,1,0,1
49CHI,2006 Winter Olympics,49,CHI,Chile,6,0,0,0,0
26CHI,2004 Summer Olympics,26,CHI,Chile,13,3,0,1,4
47CHI,2002 Winter Olympics,47,CHI,Chile,6,0,0,0,0
25CHI,2000 Summer Olympics,25,CHI,Chile,48,0,0,22,22
46CHI,1998 Winter Olympics,46,CHI,Chile,2,0,0,0,0
24CHI,1996 Summer Olympics,24,CHI,Chile,17,0,0,0,0
45CHI,1994 Winter Olympics,45,CHI,Chile,0,0,0,0,0
44CHI,1992 Winter Olympics,44,CHI,Chile,5,0,0,0,0
23CHI,1992 Summer Olympics,23,CHI,Chile,10,0,0,0,0
43CHI,1988 Winter Olympics,43,CHI,Chile,4,0,0,0,0
22CHI,1988 Summer Olympics,22,CHI,Chile,9,0,1,0,1
42CHI,1984 Winter Olympics,42,CHI,Chile,4,0,0,0,0
21CHI,1984 Summer Olympics,21,CHI,Chile,53,0,0,0,0
40CHI,1976 Winter Olympics,40,CHI,Chile,5,0,0,0,0
19CHI,1976 Summer Olympics,19,CHI,Chile,5,0,0,0,0
18CHI,1972 Summer Olympics,18,CHI,Chile,9,0,0,0,0
38CHI,1968 Winter Olympics,38,CHI,Chile,4,0,0,0,0
17CHI,1968 Summer Olympics,17,CHI,Chile,18,0,0,0,0
37CHI,1964 Winter Olympics,37,CHI,Chile,2,0,0,0,0
16CHI,1964 Summer Olympics,16,CHI,Chile,12,0,0,0,0
36CHI,1960 Winter Olympics,36,CHI,Chile,5,0,0,0,0
15CHI,1960 Summer Olympics,15,CHI,Chile,6,0,0,0,0
35CHI,1956 Winter Olympics,35,CHI,Chile,1,0,0,0,0
14CHI,1956 Summer Olympics,14,CHI,Chile,23,0,2,2,4
34CHI,1952 Winter Olympics,34,CHI,Chile,2,0,0,0,0
13CHI,1952 Summer Olympics,13,CHI,Chile,53,0,4,0,4
33CHI,1948 Winter Olympics,33,CHI,Chile,5,0,0,0,0
12CHI,1948 Summer Olympics,12,CHI,Chile,58,0,0,0,0
11CHI,1936 Summer Olympics,11,CHI,Chile,46,0,0,0,0
9CHI,1928 Summer Olympics,9,CHI,Chile,42,0,1,0,1
8CHI,1924 Summer Olympics,8,CHI,Chile,15,0,0,0,0
7CHI,1920 Summer Olympics,7,CHI,Chile,2,0,0,0,0
6CHI,1912 Summer Olympics,6,CHI,Chile,14,0,0,0,0
61GAB,2020 Summer Olympics,61,GAB,Gabon,3,0,0,0,0
59GAB,2016 Summer Olympics,59,GAB,Gabon,3,0,0,0,0
54GAB,2012 Summer Olympics,54,GAB,Gabon,26,0,1,0,1
53GAB,2008 Summer Olympics,53,GAB,Gabon,3,0,0,0,0
26GAB,2004 Summer Olympics,26,GAB,Gabon,4,0,0,0,0
25GAB,2000 Summer Olympics,25,GAB,Gabon,3,0,0,0,0
24GAB,1996 Summer Olympics,24,GAB,Gabon,5,0,0,0,0
23GAB,1992 Summer Olympics,23,GAB,Gabon,5,0,0,0,0
22GAB,1988 Summer Olympics,22,GAB,Gabon,1,0,0,0,0
21GAB,1984 Summer Olympics,21,GAB,Gabon,4,0,0,0,0
18GAB,1972 Summer Olympics,18,GAB,Gabon,2,0,0,0,0
62TPE,2022 Winter Olympics,62,TPE,Chinese Taipei,3,0,0,0,0
61TPE,2020 Summer Olympics,61,TPE,Chinese Taipei,42,3,6,7,16
60TPE,2018 Winter Olympics,60,TPE,Chinese Taipei,2,0,0,0,0
59TPE,2016 Summer Olympics,59,TPE,Chinese Taipei,37,1,0,4,5
58TPE,2014 Winter Olympics,58,TPE,Chinese Taipei,3,0,0,0,0
54TPE,2012 Summer Olympics,54,TPE,Chinese Taipei,26,1,0,1,2
57TPE,2010 Winter Olympics,57,TPE,Chinese Taipei,0,0,0,0,0
53TPE,2008 Summer Olympics,53,TPE,Chinese Taipei,44,1,1,2,4
49TPE,2006 Winter Olympics,49,TPE,Chinese Taipei,1,0,0,0,0
26TPE,2004 Summer Olympics,26,TPE,Chinese Taipei,76,2,4,3,9
47TPE,2002 Winter Olympics,47,TPE,Chinese Taipei,5,0,0,0,0
25TPE,2000 Summer Olympics,25,TPE,Chinese Taipei,39,0,1,4,5
46TPE,1998 Winter Olympics,46,TPE,Chinese Taipei,5,0,0,0,0
24TPE,1996 Summer Olympics,24,TPE,Chinese Taipei,66,0,1,0,1
45TPE,1994 Winter Olympics,45,TPE,Chinese Taipei,0,0,0,0,0
44TPE,1992 Winter Olympics,44,TPE,Chinese Taipei,2,0,0,0,0
23TPE,1992 Summer Olympics,23,TPE,Chinese Taipei,28,0,20,0,20
43TPE,1988 Winter Olympics,43,TPE,Chinese Taipei,8,0,0,0,0
22TPE,1988 Summer Olympics,22,TPE,Chinese Taipei,74,0,0,0,0
42TPE,1984 Winter Olympics,42,TPE,Chinese Taipei,11,0,0,0,0
21TPE,1984 Summer Olympics,21,TPE,Chinese Taipei,59,0,0,1,1
40TPE,1976 Winter Olympics,40,TPE,Chinese Taipei,4,0,0,0,0
39TPE,1972 Winter Olympics,39,TPE,Chinese Taipei,5,0,0,0,0
18TPE,1972 Summer Olympics,18,TPE,Chinese Taipei,14,0,0,0,0
17TPE,1968 Summer Olympics,17,TPE,Chinese Taipei,28,0,0,1,1
16TPE,1964 Summer Olympics,16,TPE,Chinese Taipei,38,0,0,0,0
15TPE,1960 Summer Olympics,15,TPE,Chinese Taipei,31,0,1,0,1
14TPE,1956 Summer Olympics,14,TPE,Chinese Taipei,21,0,0,0,0
61SWZ,2020 Summer Olympics,61,SWZ,Eswatini,3,0,0,0,0
59SWZ,2016 Summer Olympics,59,SWZ,Eswatini,0,0,0,0,0
54SWZ,2012 Summer Olympics,54,SWZ,Eswatini,2,0,0,0,0
53SWZ,2008 Summer Olympics,53,SWZ,Eswatini,4,0,0,0,0
26SWZ,2004 Summer Olympics,26,SWZ,Eswatini,2,0,0,0,0
25SWZ,2000 Summer Olympics,25,SWZ,Eswatini,6,0,0,0,0
24SWZ,1996 Summer Olympics,24,SWZ,Eswatini,5,0,0,0,0
44SWZ,1992 Winter Olympics,44,SWZ,Eswatini,1,0,0,0,0
23SWZ,1992 Summer Olympics,23,SWZ,Eswatini,5,0,0,0,0
22SWZ,1988 Summer Olympics,22,SWZ,Eswatini,8,0,0,0,0
21SWZ,1984 Summer Olympics,21,SWZ,Eswatini,8,0,0,0,0
18SWZ,1972 Summer Olympics,18,SWZ,Eswatini,2,0,0,0,0
61FSM,2020 Summer Olympics,61,FSM,Federated States of Micronesia,3,0,0,0,0
59FSM,2016 Summer Olympics,59,FSM,Federated States of Micronesia,4,0,0,0,0
54FSM,2012 Summer Olympics,54,FSM,Federated States of Micronesia,2,0,0,0,0
53FSM,2008 Summer Olympics,53,FSM,Federated States of Micronesia,4,0,0,0,0
26FSM,2004 Summer Olympics,26,FSM,Federated States of Micronesia,3,0,0,0,0
25FSM,2000 Summer Olympics,25,FSM,Federated States of Micronesia,5,0,0,0,0
62ECU,2022 Winter Olympics,62,ECU,Ecuador,1,0,0,0,0
61ECU,2020 Summer Olympics,61,ECU,Ecuador,30,2,1,0,3
60ECU,2018 Winter Olympics,60,ECU,Ecuador,1,0,0,0,0
59ECU,2016 Summer Olympics,59,ECU,Ecuador,19,0,0,0,0
54ECU,2012 Summer Olympics,54,ECU,Ecuador,30,0,0,0,0
53ECU,2008 Summer Olympics,53,ECU,Ecuador,15,0,1,0,1
26ECU,2004 Summer Olympics,26,ECU,Ecuador,10,0,0,0,0
25ECU,2000 Summer Olympics,25,ECU,Ecuador,4,0,0,0,0
62CRO,2022 Winter Olympics,62,CRO,Croatia,5,0,0,0,0
61CRO,2020 Summer Olympics,61,CRO,Croatia,34,5,4,2,11
60CRO,2018 Winter Olympics,60,CRO,Croatia,12,0,0,0,0
59CRO,2016 Summer Olympics,59,CRO,Croatia,48,7,15,2,24
58CRO,2014 Winter Olympics,58,CRO,Croatia,7,0,1,0,1
54CRO,2012 Summer Olympics,54,CRO,Croatia,69,15,4,16,35
57CRO,2010 Winter Olympics,57,CRO,Croatia,8,0,2,1,3
53CRO,2008 Summer Olympics,53,CRO,Croatia,62,0,2,3,5
49CRO,2006 Winter Olympics,49,CRO,Croatia,11,1,2,0,3
26CRO,2004 Summer Olympics,26,CRO,Croatia,44,15,3,3,21
47CRO,2002 Winter Olympics,47,CRO,Croatia,12,3,1,0,4
25CRO,2000 Summer Olympics,25,CRO,Croatia,58,1,0,9,10
46CRO,1998 Winter Olympics,46,CRO,Croatia,4,0,0,0,0
24CRO,1996 Summer Olympics,24,CRO,Croatia,66,16,13,0,29
45CRO,1994 Winter Olympics,45,CRO,Croatia,1,0,0,0,0
44CRO,1992 Winter Olympics,44,CRO,Croatia,4,0,0,0,0
23CRO,1992 Summer Olympics,23,CRO,Croatia,40,0,12,3,15
24ECU,1996 Summer Olympics,24,ECU,Ecuador,16,1,0,0,1
23ECU,1992 Summer Olympics,23,ECU,Ecuador,9,0,0,0,0
22ECU,1988 Summer Olympics,22,ECU,Ecuador,13,0,0,0,0
21ECU,1984 Summer Olympics,21,ECU,Ecuador,10,0,0,0,0
20ECU,1980 Summer Olympics,20,ECU,Ecuador,12,0,0,0,0
19ECU,1976 Summer Olympics,19,ECU,Ecuador,3,0,0,0,0
18ECU,1972 Summer Olympics,18,ECU,Ecuador,3,0,0,0,0
17ECU,1968 Summer Olympics,17,ECU,Ecuador,21,0,0,0,0
8ECU,1924 Summer Olympics,8,ECU,Ecuador,3,0,0,0,0
62COL,2022 Winter Olympics,62,COL,Colombia,1,0,0,0,0
61COL,2020 Summer Olympics,61,COL,Colombia,31,0,4,1,5
60COL,2018 Winter Olympics,60,COL,Colombia,4,0,0,0,0
59COL,2016 Summer Olympics,59,COL,Colombia,101,3,2,3,8
54COL,2012 Summer Olympics,54,COL,Colombia,77,1,3,5,9
57COL,2010 Winter Olympics,57,COL,Colombia,1,0,0,0,0
53COL,2008 Summer Olympics,53,COL,Colombia,44,0,2,1,3
26COL,2004 Summer Olympics,26,COL,Colombia,37,0,0,2,2
25COL,2000 Summer Olympics,25,COL,Colombia,29,1,0,0,1
24COL,1996 Summer Olympics,24,COL,Colombia,34,0,0,0,0
23COL,1992 Summer Olympics,23,COL,Colombia,41,0,0,1,1
22COL,1988 Summer Olympics,22,COL,Colombia,36,0,0,1,1
21COL,1984 Summer Olympics,21,COL,Colombia,35,0,1,0,1
20COL,1980 Summer Olympics,20,COL,Colombia,20,0,0,0,0
19COL,1976 Summer Olympics,19,COL,Colombia,25,0,0,0,0
18COL,1972 Summer Olympics,18,COL,Colombia,54,0,1,2,3
17COL,1968 Summer Olympics,17,COL,Colombia,39,0,0,0,0
16COL,1964 Summer Olympics,16,COL,Colombia,18,0,0,0,0
15COL,1960 Summer Olympics,15,COL,Colombia,11,0,0,0,0
14COL,1956 Summer Olympics,14,COL,Colombia,26,0,0,0,0
12COL,1948 Summer Olympics,12,COL,Colombia,7,0,0,0,0
11COL,1936 Summer Olympics,11,COL,Colombia,6,0,0,0,0
10COL,1932 Summer Olympics,10,COL,Colombia,2,0,0,0,0
61DOM,2020 Summer Olympics,61,DOM,Dominican Republic,50,0,7,25,32
59DOM,2016 Summer Olympics,59,DOM,Dominican Republic,19,0,0,1,1
54DOM,2012 Summer Olympics,54,DOM,Dominican Republic,24,1,1,0,2
53DOM,2008 Summer Olympics,53,DOM,Dominican Republic,16,1,1,0,2
26DOM,2004 Summer Olympics,26,DOM,Dominican Republic,25,1,0,0,1
25DOM,2000 Summer Olympics,25,DOM,Dominican Republic,11,0,0,0,0
24DOM,1996 Summer Olympics,24,DOM,Dominican Republic,14,0,0,0,0
23DOM,1992 Summer Olympics,23,DOM,Dominican Republic,31,0,0,0,0
22DOM,1988 Summer Olympics,22,DOM,Dominican Republic,14,0,0,0,0
21DOM,1984 Summer Olympics,21,DOM,Dominican Republic,37,0,0,1,1
20DOM,1980 Summer Olympics,20,DOM,Dominican Republic,6,0,0,0,0
19DOM,1976 Summer Olympics,19,DOM,Dominican Republic,11,0,0,0,0
18DOM,1972 Summer Olympics,18,DOM,Dominican Republic,3,0,0,0,0
17DOM,1968 Summer Olympics,17,DOM,Dominican Republic,18,0,0,0,0
16DOM,1964 Summer Olympics,16,DOM,Dominican Republic,1,0,0,0,0
60PRK,2018 Winter Olympics,60,PRK,Democratic People's Republic of Korea,10,0,0,0,0
59PRK,2016 Summer Olympics,59,PRK,Democratic People's Republic of Korea,18,2,3,2,7
54PRK,2012 Summer Olympics,54,PRK,Democratic People's Republic of Korea,45,4,0,3,7
57PRK,2010 Winter Olympics,57,PRK,Democratic People's Republic of Korea,2,0,0,0,0
53PRK,2008 Summer Olympics,53,PRK,Democratic People's Republic of Korea,54,2,2,2,6
49PRK,2006 Winter Olympics,49,PRK,Democratic People's Republic of Korea,6,0,0,0,0
26PRK,2004 Summer Olympics,26,PRK,Democratic People's Republic of Korea,27,0,4,1,5
25PRK,2000 Summer Olympics,25,PRK,Democratic People's Republic of Korea,21,0,1,3,4
46PRK,1998 Winter Olympics,46,PRK,Democratic People's Republic of Korea,8,0,0,0,0
24PRK,1996 Summer Olympics,24,PRK,Democratic People's Republic of Korea,16,2,1,2,5
44PRK,1992 Winter Olympics,44,PRK,Democratic People's Republic of Korea,19,0,0,1,1
23PRK,1992 Summer Olympics,23,PRK,Democratic People's Republic of Korea,63,4,0,6,10
43PRK,1988 Winter Olympics,43,PRK,Democratic People's Republic of Korea,4,0,0,0,0
42PRK,1984 Winter Olympics,42,PRK,Democratic People's Republic of Korea,6,0,0,0,0
20PRK,1980 Summer Olympics,20,PRK,Democratic People's Republic of Korea,35,0,3,2,5
19PRK,1976 Summer Olympics,19,PRK,Democratic People's Republic of Korea,38,1,1,0,2
39PRK,1972 Winter Olympics,39,PRK,Democratic People's Republic of Korea,5,0,0,0,0
18PRK,1972 Summer Olympics,18,PRK,Democratic People's Republic of Korea,39,1,1,14,16
37PRK,1964 Winter Olympics,37,PRK,Democratic People's Republic of Korea,15,0,1,0,1
61ESA,2020 Summer Olympics,61,ESA,El Salvador,3,0,0,0,0
59ESA,2016 Summer Olympics,59,ESA,El Salvador,7,0,0,0,0
54ESA,2012 Summer Olympics,54,ESA,El Salvador,8,0,0,0,0
53ESA,2008 Summer Olympics,53,ESA,El Salvador,7,0,0,0,0
26ESA,2004 Summer Olympics,26,ESA,El Salvador,6,0,0,0,0
25ESA,2000 Summer Olympics,25,ESA,El Salvador,6,0,0,0,0
24ESA,1996 Summer Olympics,24,ESA,El Salvador,7,0,0,0,0
23ESA,1992 Summer Olympics,23,ESA,El Salvador,3,0,0,0,0
22ESA,1988 Summer Olympics,22,ESA,El Salvador,3,0,0,0,0
21ESA,1984 Summer Olympics,21,ESA,El Salvador,10,0,0,0,0
18ESA,1972 Summer Olympics,18,ESA,El Salvador,8,0,0,0,0
17ESA,1968 Summer Olympics,17,ESA,El Salvador,61,0,0,0,0
10ESA,1932 Summer Olympics,10,ESA,El Salvador,1,0,0,0,0
62ERI,2022 Winter Olympics,62,ERI,Eritrea,0,0,0,0,0
61ERI,2020 Summer Olympics,61,ERI,Eritrea,10,0,0,0,0
60ERI,2018 Winter Olympics,60,ERI,Eritrea,1,0,0,0,0
59ERI,2016 Summer Olympics,59,ERI,Eritrea,6,0,0,0,0
54ERI,2012 Summer Olympics,54,ERI,Eritrea,8,0,0,0,0
53ERI,2008 Summer Olympics,53,ERI,Eritrea,7,0,0,0,0
26ERI,2004 Summer Olympics,26,ERI,Eritrea,2,0,0,1,1
25ERI,2000 Summer Olympics,25,ERI,Eritrea,3,0,0,0,0
61GEQ,2020 Summer Olympics,61,GEQ,Equatorial Guinea,2,0,0,0,0
59GEQ,2016 Summer Olympics,59,GEQ,Equatorial Guinea,1,0,0,0,0
54GEQ,2012 Summer Olympics,54,GEQ,Equatorial Guinea,2,0,0,0,0
53GEQ,2008 Summer Olympics,53,GEQ,Equatorial Guinea,2,0,0,0,0
26GEQ,2004 Summer Olympics,26,GEQ,Equatorial Guinea,2,0,0,0,0
25GEQ,2000 Summer Olympics,25,GEQ,Equatorial Guinea,4,0,0,0,0
24GEQ,1996 Summer Olympics,24,GEQ,Equatorial Guinea,3,0,0,0,0
23GEQ,1992 Summer Olympics,23,GEQ,Equatorial Guinea,5,0,0,0,0
22GEQ,1988 Summer Olympics,22,GEQ,Equatorial Guinea,4,0,0,0,0
21GEQ,1984 Summer Olympics,21,GEQ,Equatorial Guinea,4,0,0,0,0
62CYP,2022 Winter Olympics,62,CYP,Cyprus,1,0,0,0,0
61CYP,2020 Summer Olympics,61,CYP,Cyprus,6,0,0,0,0
60CYP,2018 Winter Olympics,60,CYP,Cyprus,1,0,0,0,0
59CYP,2016 Summer Olympics,59,CYP,Cyprus,10,0,0,0,0
58CYP,2014 Winter Olympics,58,CYP,Cyprus,2,0,0,0,0
54CYP,2012 Summer Olympics,54,CYP,Cyprus,5,0,1,0,1
57CYP,2010 Winter Olympics,57,CYP,Cyprus,2,0,0,0,0
53CYP,2008 Summer Olympics,53,CYP,Cyprus,8,0,0,0,0
49CYP,2006 Winter Olympics,49,CYP,Cyprus,0,0,0,0,0
26CYP,2004 Summer Olympics,26,CYP,Cyprus,12,0,0,0,0
47CYP,2002 Winter Olympics,47,CYP,Cyprus,1,0,0,0,0
25CYP,2000 Summer Olympics,25,CYP,Cyprus,14,0,0,0,0
46CYP,1998 Winter Olympics,46,CYP,Cyprus,0,0,0,0,0
24CYP,1996 Summer Olympics,24,CYP,Cyprus,12,0,0,0,0
45CYP,1994 Winter Olympics,45,CYP,Cyprus,0,0,0,0,0
44CYP,1992 Winter Olympics,44,CYP,Cyprus,2,0,0,0,0
23CYP,1992 Summer Olympics,23,CYP,Cyprus,14,0,0,0,0
43CYP,1988 Winter Olympics,43,CYP,Cyprus,2,0,0,0,0
22CYP,1988 Summer Olympics,22,CYP,Cyprus,9,0,0,0,0
42CYP,1984 Winter Olympics,42,CYP,Cyprus,4,0,0,0,0
21CYP,1984 Summer Olympics,21,CYP,Cyprus,9,0,0,0,0
41CYP,1980 Winter Olympics,41,CYP,Cyprus,3,0,0,0,0
20CYP,1980 Summer Olympics,20,CYP,Cyprus,14,0,0,0,0
61CRC,2020 Summer Olympics,61,CRC,Costa Rica,13,0,0,0,0
59CRC,2016 Summer Olympics,59,CRC,Costa Rica,6,0,0,0,0
54CRC,2012 Summer Olympics,54,CRC,Costa Rica,8,0,0,0,0
53CRC,2008 Summer Olympics,53,CRC,Costa Rica,7,0,0,0,0
49CRC,2006 Winter Olympics,49,CRC,Costa Rica,0,0,0,0,0
26CRC,2004 Summer Olympics,26,CRC,Costa Rica,25,0,0,0,0
47CRC,2002 Winter Olympics,47,CRC,Costa Rica,0,0,0,0,0
25CRC,2000 Summer Olympics,25,CRC,Costa Rica,4,0,0,2,2
24CRC,1996 Summer Olympics,24,CRC,Costa Rica,7,1,0,0,1
44CRC,1992 Winter Olympics,44,CRC,Costa Rica,3,0,0,0,0
23CRC,1992 Summer Olympics,23,CRC,Costa Rica,13,0,0,0,0
43CRC,1988 Winter Olympics,43,CRC,Costa Rica,1,0,0,0,0
22CRC,1988 Summer Olympics,22,CRC,Costa Rica,14,0,1,0,1
42CRC,1984 Winter Olympics,42,CRC,Costa Rica,2,0,0,0,0
21CRC,1984 Summer Olympics,21,CRC,Costa Rica,20,0,0,0,0
41CRC,1980 Winter Olympics,41,CRC,Costa Rica,1,0,0,0,0
20CRC,1980 Summer Olympics,20,CRC,Costa Rica,26,0,0,0,0
19CRC,1976 Summer Olympics,19,CRC,Costa Rica,4,0,0,0,0
18CRC,1972 Summer Olympics,18,CRC,Costa Rica,1,0,0,0,0
17CRC,1968 Summer Olympics,17,CRC,Costa Rica,20,0,0,0,0
16CRC,1964 Summer Olympics,16,CRC,Costa Rica,2,0,0,0,0
11CRC,1936 Summer Olympics,11,CRC,Costa Rica,1,0,0,0,0
61DMA,2020 Summer Olympics,61,DMA,Dominica,1,0,0,0,0
59DMA,2016 Summer Olympics,59,DMA,Dominica,2,0,0,0,0
58DMA,2014 Winter Olympics,58,DMA,Dominica,2,0,0,0,0
54DMA,2012 Summer Olympics,54,DMA,Dominica,1,0,0,0,0
53DMA,2008 Summer Olympics,53,DMA,Dominica,1,0,0,0,0
26DMA,2004 Summer Olympics,26,DMA,Dominica,2,0,0,0,0
25DMA,2000 Summer Olympics,25,DMA,Dominica,4,0,0,0,0
24DMA,1996 Summer Olympics,24,DMA,Dominica,6,0,0,0,0
61DJI,2020 Summer Olympics,61,DJI,Djibouti,2,0,0,0,0
59DJI,2016 Summer Olympics,59,DJI,Djibouti,6,0,0,0,0
54DJI,2012 Summer Olympics,54,DJI,Djibouti,5,0,0,0,0
53DJI,2008 Summer Olympics,53,DJI,Djibouti,2,0,0,0,0
25DJI,2000 Summer Olympics,25,DJI,Djibouti,1,0,0,0,0
24DJI,1996 Summer Olympics,24,DJI,Djibouti,2,0,0,0,0
23DJI,1992 Summer Olympics,23,DJI,Djibouti,5,0,0,0,0
22DJI,1988 Summer Olympics,22,DJI,Djibouti,5,0,0,1,1
21DJI,1984 Summer Olympics,21,DJI,Djibouti,3,0,0,0,0
61COD,2020 Summer Olympics,61,COD,Democratic Republic of the Congo,7,0,0,0,0
59COD,2016 Summer Olympics,59,COD,Democratic Republic of the Congo,4,0,0,0,0
54COD,2012 Summer Olympics,54,COD,Democratic Republic of the Congo,4,0,0,0,0
53COD,2008 Summer Olympics,53,COD,Democratic Republic of the Congo,4,0,0,0,0
26COD,2004 Summer Olympics,26,COD,Democratic Republic of the Congo,4,0,0,0,0
25COD,2000 Summer Olympics,25,COD,Democratic Republic of the Congo,1,0,0,0,0
24COD,1996 Summer Olympics,24,COD,Democratic Republic of the Congo,12,0,0,0,0
23COD,1992 Summer Olympics,23,COD,Democratic Republic of the Congo,13,0,0,0,0
22COD,1988 Summer Olympics,22,COD,Democratic Republic of the Congo,15,0,0,0,0
21COD,1984 Summer Olympics,21,COD,Democratic Republic of the Congo,8,0,0,0,0
17COD,1968 Summer Olympics,17,COD,Democratic Republic of the Congo,5,0,0,0,0
61CIV,2020 Summer Olympics,61,CIV,Côte d'Ivoire,25,0,0,1,1
59CIV,2016 Summer Olympics,59,CIV,Côte d'Ivoire,8,1,0,1,2
54CIV,2012 Summer Olympics,54,CIV,Côte d'Ivoire,8,0,0,0,0
53CIV,2008 Summer Olympics,53,CIV,Côte d'Ivoire,19,0,0,0,0
26CIV,2004 Summer Olympics,26,CIV,Côte d'Ivoire,2,0,0,0,0
25CIV,2000 Summer Olympics,25,CIV,Côte d'Ivoire,10,0,0,0,0
24CIV,1996 Summer Olympics,24,CIV,Côte d'Ivoire,7,0,0,0,0
23CIV,1992 Summer Olympics,23,CIV,Côte d'Ivoire,12,0,0,0,0
22CIV,1988 Summer Olympics,22,CIV,Côte d'Ivoire,25,0,0,0,0
21CIV,1984 Summer Olympics,21,CIV,Côte d'Ivoire,11,0,1,0,1
19CIV,1976 Summer Olympics,19,CIV,Côte d'Ivoire,6,0,0,0,0
18CIV,1972 Summer Olympics,18,CIV,Côte d'Ivoire,8,0,0,0,0
17CIV,1968 Summer Olympics,17,CIV,Côte d'Ivoire,8,0,0,0,0
16CIV,1964 Summer Olympics,16,CIV,Côte d'Ivoire,9,0,0,0,0
62BLR,2022 Winter Olympics,62,BLR,Belarus,14,0,2,0,2
61BLR,2020 Summer Olympics,61,BLR,Belarus,71,1,6,3,10
60BLR,2018 Winter Olympics,60,BLR,Belarus,19,5,1,0,6
59BLR,2016 Summer Olympics,59,BLR,Belarus,68,1,4,7,12
58BLR,2014 Winter Olympics,58,BLR,Belarus,11,5,0,1,6
54BLR,2012 Summer Olympics,54,BLR,Belarus,96,3,12,6,21
57BLR,2010 Winter Olympics,57,BLR,Belarus,28,1,1,1,3
53BLR,2008 Summer Olympics,53,BLR,Belarus,107,7,4,14,25
49BLR,2006 Winter Olympics,49,BLR,Belarus,11,0,1,0,1
26BLR,2004 Summer Olympics,26,BLR,Belarus,99,2,5,8,15
47BLR,2002 Winter Olympics,47,BLR,Belarus,34,0,0,1,1
25BLR,2000 Summer Olympics,25,BLR,Belarus,85,3,8,11,22
46BLR,1998 Winter Olympics,46,BLR,Belarus,44,0,0,2,2
24BLR,1996 Summer Olympics,24,BLR,Belarus,157,1,6,16,23
45BLR,1994 Winter Olympics,45,BLR,Belarus,32,0,2,0,2
61CGO,2020 Summer Olympics,61,CGO,Congo,2,0,0,0,0
59CGO,2016 Summer Olympics,59,CGO,Congo,8,0,0,0,0
54CGO,2012 Summer Olympics,54,CGO,Congo,5,0,0,0,0
53CGO,2008 Summer Olympics,53,CGO,Congo,4,0,0,0,0
26CGO,2004 Summer Olympics,26,CGO,Congo,5,0,0,0,0
25CGO,2000 Summer Olympics,25,CGO,Congo,3,0,0,0,0
24CGO,1996 Summer Olympics,24,CGO,Congo,5,0,0,0,0
23CGO,1992 Summer Olympics,23,CGO,Congo,6,0,0,0,0
22CGO,1988 Summer Olympics,22,CGO,Congo,5,0,0,0,0
21CGO,1984 Summer Olympics,21,CGO,Congo,7,0,0,0,0
20CGO,1980 Summer Olympics,20,CGO,Congo,20,0,0,0,0
18CGO,1972 Summer Olympics,18,CGO,Congo,7,0,0,0,0
16CGO,1964 Summer Olympics,16,CGO,Congo,2,0,0,0,0
61CMR,2020 Summer Olympics,61,CMR,Cameroon,8,0,0,0,0
59CMR,2016 Summer Olympics,59,CMR,Cameroon,21,0,0,0,0
54CMR,2012 Summer Olympics,54,CMR,Cameroon,32,0,0,1,1
53CMR,2008 Summer Olympics,53,CMR,Cameroon,30,1,0,0,1
26CMR,2004 Summer Olympics,26,CMR,Cameroon,15,1,0,0,1
47CMR,2002 Winter Olympics,47,CMR,Cameroon,1,0,0,0,0
25CMR,2000 Summer Olympics,25,CMR,Cameroon,32,19,0,0,19
24CMR,1996 Summer Olympics,24,CMR,Cameroon,13,0,0,0,0
23CMR,1992 Summer Olympics,23,CMR,Cameroon,8,0,0,0,0
22CMR,1988 Summer Olympics,22,CMR,Cameroon,11,0,0,0,0
21CMR,1984 Summer Olympics,21,CMR,Cameroon,38,0,0,1,1
20CMR,1980 Summer Olympics,20,CMR,Cameroon,23,0,0,0,0
19CMR,1976 Summer Olympics,19,CMR,Cameroon,5,0,0,0,0
18CMR,1972 Summer Olympics,18,CMR,Cameroon,10,0,0,0,0
17CMR,1968 Summer Olympics,17,CMR,Cameroon,6,0,1,0,1
16CMR,1964 Summer Olympics,16,CMR,Cameroon,1,0,0,0,0
61COK,2020 Summer Olympics,61,COK,Cook Islands,4,0,0,0,0
59COK,2016 Summer Olympics,59,COK,Cook Islands,6,0,0,0,0
54COK,2012 Summer Olympics,54,COK,Cook Islands,8,0,0,0,0
53COK,2008 Summer Olympics,53,COK,Cook Islands,3,0,0,0,0
26COK,2004 Summer Olympics,26,COK,Cook Islands,2,0,0,0,0
25COK,2000 Summer Olympics,25,COK,Cook Islands,1,0,0,0,0
24COK,1996 Summer Olympics,24,COK,Cook Islands,1,0,0,0,0
23COK,1992 Summer Olympics,23,COK,Cook Islands,2,0,0,0,0
22COK,1988 Summer Olympics,22,COK,Cook Islands,7,0,0,0,0
61CHA,2020 Summer Olympics,61,CHA,Chad,2,0,0,0,0
59CHA,2016 Summer Olympics,59,CHA,Chad,2,0,0,0,0
54CHA,2012 Summer Olympics,54,CHA,Chad,1,0,0,0,0
53CHA,2008 Summer Olympics,53,CHA,Chad,1,0,0,0,0
26CHA,2004 Summer Olympics,26,CHA,Chad,1,0,0,0,0
25CHA,2000 Summer Olympics,25,CHA,Chad,1,0,0,0,0
24CHA,1996 Summer Olympics,24,CHA,Chad,3,0,0,0,0
23CHA,1992 Summer Olympics,23,CHA,Chad,4,0,0,0,0
22CHA,1988 Summer Olympics,22,CHA,Chad,6,0,0,0,0
21CHA,1984 Summer Olympics,21,CHA,Chad,3,0,0,0,0
18CHA,1972 Summer Olympics,18,CHA,Chad,3,0,0,0,0
17CHA,1968 Summer Olympics,17,CHA,Chad,2,0,0,0,0
16CHA,1964 Summer Olympics,16,CHA,Chad,2,0,0,0,0
61COM,2020 Summer Olympics,61,COM,Comoros,3,0,0,0,0
59COM,2016 Summer Olympics,59,COM,Comoros,3,0,0,0,0
54COM,2012 Summer Olympics,54,COM,Comoros,2,0,0,0,0
53COM,2008 Summer Olympics,53,COM,Comoros,3,0,0,0,0
26COM,2004 Summer Olympics,26,COM,Comoros,2,0,0,0,0
25COM,2000 Summer Olympics,25,COM,Comoros,1,0,0,0,0
24COM,1996 Summer Olympics,24,COM,Comoros,4,0,0,0,0
61CAF,2020 Summer Olympics,61,CAF,Central African Republic,0,0,0,0,0
59CAF,2016 Summer Olympics,59,CAF,Central African Republic,3,0,0,0,0
54CAF,2012 Summer Olympics,54,CAF,Central African Republic,5,0,0,0,0
53CAF,2008 Summer Olympics,53,CAF,Central African Republic,3,0,0,0,0
26CAF,2004 Summer Olympics,26,CAF,Central African Republic,2,0,0,0,0
25CAF,2000 Summer Olympics,25,CAF,Central African Republic,2,0,0,0,0
24CAF,1996 Summer Olympics,24,CAF,Central African Republic,2,0,0,0,0
23CAF,1992 Summer Olympics,23,CAF,Central African Republic,15,0,0,0,0
22CAF,1988 Summer Olympics,22,CAF,Central African Republic,14,0,0,0,0
21CAF,1984 Summer Olympics,21,CAF,Central African Republic,3,0,0,0,0
17CAF,1968 Summer Olympics,17,CAF,Central African Republic,1,0,0,0,0
61CAY,2020 Summer Olympics,61,CAY,Cayman Islands,3,0,0,0,0
59CAY,2016 Summer Olympics,59,CAY,Cayman Islands,3,0,0,0,0
58CAY,2014 Winter Olympics,58,CAY,Cayman Islands,0,0,0,0,0
54CAY,2012 Summer Olympics,54,CAY,Cayman Islands,1,0,0,0,0
57CAY,2010 Winter Olympics,57,CAY,Cayman Islands,1,0,0,0,0
53CAY,2008 Summer Olympics,53,CAY,Cayman Islands,2,0,0,0,0
26CAY,2004 Summer Olympics,26,CAY,Cayman Islands,3,0,0,0,0
25CAY,2000 Summer Olympics,25,CAY,Cayman Islands,1,0,0,0,0
24CAY,1996 Summer Olympics,24,CAY,Cayman Islands,6,0,0,0,0
23CAY,1992 Summer Olympics,23,CAY,Cayman Islands,6,0,0,0,0
22CAY,1988 Summer Olympics,22,CAY,Cayman Islands,6,0,0,0,0
21CAY,1984 Summer Olympics,21,CAY,Cayman Islands,8,0,0,0,0
19CAY,1976 Summer Olympics,19,CAY,Cayman Islands,2,0,0,0,0
61ALG,2020 Summer Olympics,61,ALG,Algeria,27,0,0,0,0
59ALG,2016 Summer Olympics,59,ALG,Algeria,56,0,2,0,2
54ALG,2012 Summer Olympics,54,ALG,Algeria,25,1,0,0,1
57ALG,2010 Winter Olympics,57,ALG,Algeria,1,0,0,0,0
53ALG,2008 Summer Olympics,53,ALG,Algeria,41,0,1,1,2
49ALG,2006 Winter Olympics,49,ALG,Algeria,2,0,0,0,0
26ALG,2004 Summer Olympics,26,ALG,Algeria,36,0,0,0,0
25ALG,2000 Summer Olympics,25,ALG,Algeria,36,1,1,3,5
24ALG,1996 Summer Olympics,24,ALG,Algeria,35,2,0,1,3
44ALG,1992 Winter Olympics,44,ALG,Algeria,4,0,0,0,0
23ALG,1992 Summer Olympics,23,ALG,Algeria,26,1,0,1,2
22ALG,1988 Summer Olympics,22,ALG,Algeria,31,0,0,0,0
21ALG,1984 Summer Olympics,21,ALG,Algeria,25,0,0,2,2
20ALG,1980 Summer Olympics,20,ALG,Algeria,59,0,0,0,0
18ALG,1972 Summer Olympics,18,ALG,Algeria,5,0,0,0,0
17ALG,1968 Summer Olympics,17,ALG,Algeria,3,0,0,0,0
16ALG,1964 Summer Olympics,16,ALG,Algeria,1,0,0,0,0
4CRT,1906  Intercalated Games,4,CRT,Crete,8,0,0,0,0
62BOL,2022 Winter Olympics,62,BOL,Bolivia,0,0,0,0,0
61BOL,2020 Summer Olympics,61,BOL,Bolivia,2,0,0,0,0
60BOL,2018 Winter Olympics,60,BOL,Bolivia,2,0,0,0,0
59BOL,2016 Summer Olympics,59,BOL,Bolivia,10,0,0,0,0
54BOL,2012 Summer Olympics,54,BOL,Bolivia,5,0,0,0,0
53BOL,2008 Summer Olympics,53,BOL,Bolivia,5,0,0,0,0
26BOL,2004 Summer Olympics,26,BOL,Bolivia,4,0,0,0,0
25BOL,2000 Summer Olympics,25,BOL,Bolivia,3,0,0,0,0
24BOL,1996 Summer Olympics,24,BOL,Bolivia,7,0,0,0,0
44BOL,1992 Winter Olympics,44,BOL,Bolivia,2,0,0,0,0
23BOL,1992 Summer Olympics,23,BOL,Bolivia,11,0,0,0,0
43BOL,1988 Winter Olympics,43,BOL,Bolivia,5,0,0,0,0
22BOL,1988 Summer Olympics,22,BOL,Bolivia,6,0,0,0,0
42BOL,1984 Winter Olympics,42,BOL,Bolivia,2,0,0,0,0
21BOL,1984 Summer Olympics,21,BOL,Bolivia,11,0,0,0,0
41BOL,1980 Winter Olympics,41,BOL,Bolivia,3,0,0,0,0
19BOL,1976 Summer Olympics,19,BOL,Bolivia,2,0,0,0,0
18BOL,1972 Summer Olympics,18,BOL,Bolivia,7,0,0,0,0
17BOL,1968 Summer Olympics,17,BOL,Bolivia,3,0,0,0,0
16BOL,1964 Summer Olympics,16,BOL,Bolivia,3,0,0,0,0
35BOL,1956 Winter Olympics,35,BOL,Bolivia,1,0,0,0,0
11BOL,1936 Summer Olympics,11,BOL,Bolivia,2,0,0,0,0
61BER,2020 Summer Olympics,61,BER,Bermuda,1,1,0,0,1
60BER,2018 Winter Olympics,60,BER,Bermuda,0,0,0,0,0
59BER,2016 Summer Olympics,59,BER,Bermuda,6,0,0,0,0
58BER,2014 Winter Olympics,58,BER,Bermuda,0,0,0,0,0
54BER,2012 Summer Olympics,54,BER,Bermuda,2,0,0,0,0
57BER,2010 Winter Olympics,57,BER,Bermuda,1,0,0,0,0
53BER,2008 Summer Olympics,53,BER,Bermuda,5,0,0,0,0
49BER,2006 Winter Olympics,49,BER,Bermuda,0,0,0,0,0
26BER,2004 Summer Olympics,26,BER,Bermuda,7,0,0,0,0
47BER,2002 Winter Olympics,47,BER,Bermuda,0,0,0,0,0
25BER,2000 Summer Olympics,25,BER,Bermuda,2,0,0,0,0
46BER,1998 Winter Olympics,46,BER,Bermuda,1,0,0,0,0
24BER,1996 Summer Olympics,24,BER,Bermuda,4,0,0,0,0
45BER,1994 Winter Olympics,45,BER,Bermuda,0,0,0,0,0
44BER,1992 Winter Olympics,44,BER,Bermuda,1,0,0,0,0
23BER,1992 Summer Olympics,23,BER,Bermuda,17,0,0,0,0
22BER,1988 Summer Olympics,22,BER,Bermuda,8,0,0,0,0
21BER,1984 Summer Olympics,21,BER,Bermuda,10,0,0,0,0
19BER,1976 Summer Olympics,19,BER,Bermuda,18,0,0,1,1
18BER,1972 Summer Olympics,18,BER,Bermuda,6,0,0,0,0
17BER,1968 Summer Olympics,17,BER,Bermuda,3,0,0,0,0
16BER,1964 Summer Olympics,16,BER,Bermuda,4,0,0,0,0
15BER,1960 Summer Olympics,15,BER,Bermuda,7,0,0,0,0
14BER,1956 Summer Olympics,14,BER,Bermuda,3,0,0,0,0
13BER,1952 Summer Olympics,13,BER,Bermuda,2,0,0,0,0
12BER,1948 Summer Olympics,12,BER,Bermuda,12,0,0,0,0
11BER,1936 Summer Olympics,11,BER,Bermuda,7,0,0,0,0
61CAM,2020 Summer Olympics,61,CAM,Cambodia,3,0,0,0,0
59CAM,2016 Summer Olympics,59,CAM,Cambodia,5,0,0,0,0
54CAM,2012 Summer Olympics,54,CAM,Cambodia,4,0,0,0,0
53CAM,2008 Summer Olympics,53,CAM,Cambodia,3,0,0,0,0
26CAM,2004 Summer Olympics,26,CAM,Cambodia,3,0,0,0,0
25CAM,2000 Summer Olympics,25,CAM,Cambodia,1,0,0,0,0
24CAM,1996 Summer Olympics,24,CAM,Cambodia,5,0,0,0,0
18CAM,1972 Summer Olympics,18,CAM,Cambodia,10,0,0,0,0
16CAM,1964 Summer Olympics,16,CAM,Cambodia,13,0,0,0,0
48CAM,1956 Equestrian Olympics,48,CAM,Cambodia,2,0,0,0,0
62AND,2022 Winter Olympics,62,AND,Andorra,3,0,0,0,0
61AND,2020 Summer Olympics,61,AND,Andorra,1,0,0,0,0
60AND,2018 Winter Olympics,60,AND,Andorra,1,0,0,0,0
59AND,2016 Summer Olympics,59,AND,Andorra,4,0,0,0,0
58AND,2014 Winter Olympics,58,AND,Andorra,3,0,0,0,0
54AND,2012 Summer Olympics,54,AND,Andorra,2,0,0,0,0
57AND,2010 Winter Olympics,57,AND,Andorra,4,0,0,0,0
53AND,2008 Summer Olympics,53,AND,Andorra,3,0,0,0,0
49AND,2006 Winter Olympics,49,AND,Andorra,2,0,0,0,0
26AND,2004 Summer Olympics,26,AND,Andorra,4,0,0,0,0
47AND,2002 Winter Olympics,47,AND,Andorra,1,0,0,0,0
25AND,2000 Summer Olympics,25,AND,Andorra,2,0,0,0,0
46AND,1998 Winter Olympics,46,AND,Andorra,0,0,0,0,0
24AND,1996 Summer Olympics,24,AND,Andorra,5,0,0,0,0
45AND,1994 Winter Olympics,45,AND,Andorra,2,0,0,0,0
44AND,1992 Winter Olympics,44,AND,Andorra,3,0,0,0,0
23AND,1992 Summer Olympics,23,AND,Andorra,6,0,0,0,0
43AND,1988 Winter Olympics,43,AND,Andorra,4,0,0,0,0
22AND,1988 Summer Olympics,22,AND,Andorra,3,0,0,0,0
42AND,1984 Winter Olympics,42,AND,Andorra,2,0,0,0,0
21AND,1984 Summer Olympics,21,AND,Andorra,0,0,0,0,0
41AND,1980 Winter Olympics,41,AND,Andorra,2,0,0,0,0
20AND,1980 Summer Olympics,20,AND,Andorra,1,0,0,0,0
40AND,1976 Winter Olympics,40,AND,Andorra,5,0,0,0,0
19AND,1976 Summer Olympics,19,AND,Andorra,3,0,0,0,0
61BUR,2020 Summer Olympics,61,BUR,Burkina Faso,3,0,0,1,1
59BUR,2016 Summer Olympics,59,BUR,Burkina Faso,3,0,0,0,0
54BUR,2012 Summer Olympics,54,BUR,Burkina Faso,5,0,0,0,0
53BUR,2008 Summer Olympics,53,BUR,Burkina Faso,3,0,0,0,0
26BUR,2004 Summer Olympics,26,BUR,Burkina Faso,3,0,0,0,0
25BUR,2000 Summer Olympics,25,BUR,Burkina Faso,4,0,0,0,0
24BUR,1996 Summer Olympics,24,BUR,Burkina Faso,5,0,0,0,0
23BUR,1992 Summer Olympics,23,BUR,Burkina Faso,3,0,0,0,0
22BUR,1988 Summer Olympics,22,BUR,Burkina Faso,6,0,0,0,0
18BUR,1972 Summer Olympics,18,BUR,Burkina Faso,1,0,0,0,0
62BIH,2022 Winter Olympics,62,BIH,Bosnia and Herzegovina,4,0,0,0,0
61BIH,2020 Summer Olympics,61,BIH,Bosnia and Herzegovina,3,0,0,0,0
60BIH,2018 Winter Olympics,60,BIH,Bosnia and Herzegovina,2,0,0,0,0
59BIH,2016 Summer Olympics,59,BIH,Bosnia and Herzegovina,8,0,0,0,0
58BIH,2014 Winter Olympics,58,BIH,Bosnia and Herzegovina,1,0,0,0,0
54BIH,2012 Summer Olympics,54,BIH,Bosnia and Herzegovina,3,0,0,0,0
57BIH,2010 Winter Olympics,57,BIH,Bosnia and Herzegovina,5,0,0,0,0
53BIH,2008 Summer Olympics,53,BIH,Bosnia and Herzegovina,3,0,0,0,0
49BIH,2006 Winter Olympics,49,BIH,Bosnia and Herzegovina,6,0,0,0,0
26BIH,2004 Summer Olympics,26,BIH,Bosnia and Herzegovina,7,0,0,0,0
47BIH,2002 Winter Olympics,47,BIH,Bosnia and Herzegovina,1,0,0,0,0
25BIH,2000 Summer Olympics,25,BIH,Bosnia and Herzegovina,7,0,0,0,0
46BIH,1998 Winter Olympics,46,BIH,Bosnia and Herzegovina,5,0,0,0,0
24BIH,1996 Summer Olympics,24,BIH,Bosnia and Herzegovina,7,0,0,0,0
45BIH,1994 Winter Olympics,45,BIH,Bosnia and Herzegovina,10,0,0,0,0
23BIH,1992 Summer Olympics,23,BIH,Bosnia and Herzegovina,10,0,0,0,0
61IVB,2020 Summer Olympics,61,IVB,British Virgin Islands,2,0,0,0,0
59IVB,2016 Summer Olympics,59,IVB,British Virgin Islands,3,0,0,0,0
58IVB,2014 Winter Olympics,58,IVB,British Virgin Islands,1,0,0,0,0
54IVB,2012 Summer Olympics,54,IVB,British Virgin Islands,1,0,0,0,0
53IVB,2008 Summer Olympics,53,IVB,British Virgin Islands,2,0,0,0,0
26IVB,2004 Summer Olympics,26,IVB,British Virgin Islands,1,0,0,0,0
25IVB,2000 Summer Olympics,25,IVB,British Virgin Islands,0,0,0,0,0
24IVB,1996 Summer Olympics,24,IVB,British Virgin Islands,6,0,0,0,0
23IVB,1992 Summer Olympics,23,IVB,British Virgin Islands,3,0,0,0,0
22IVB,1988 Summer Olympics,22,IVB,British Virgin Islands,2,0,0,0,0
42IVB,1984 Winter Olympics,42,IVB,British Virgin Islands,1,0,0,0,0
21IVB,1984 Summer Olympics,21,IVB,British Virgin Islands,9,0,0,0,0
61BOT,2020 Summer Olympics,61,BOT,Botswana,8,0,0,5,5
59BOT,2016 Summer Olympics,59,BOT,Botswana,10,0,0,0,0
54BOT,2012 Summer Olympics,54,BOT,Botswana,3,0,1,0,1
53BOT,2008 Summer Olympics,53,BOT,Botswana,7,0,0,0,0
26BOT,2004 Summer Olympics,26,BOT,Botswana,8,0,0,0,0
25BOT,2000 Summer Olympics,25,BOT,Botswana,5,0,0,0,0
24BOT,1996 Summer Olympics,24,BOT,Botswana,6,0,0,0,0
23BOT,1992 Summer Olympics,23,BOT,Botswana,4,0,0,0,0
22BOT,1988 Summer Olympics,22,BOT,Botswana,6,0,0,0,0
21BOT,1984 Summer Olympics,21,BOT,Botswana,6,0,0,0,0
20BOT,1980 Summer Olympics,20,BOT,Botswana,7,0,0,0,0
61CPV,2020 Summer Olympics,61,CPV,Cabo Verde,5,0,0,0,0
59CPV,2016 Summer Olympics,59,CPV,Cabo Verde,4,0,0,0,0
54CPV,2012 Summer Olympics,54,CPV,Cabo Verde,3,0,0,0,0
53CPV,2008 Summer Olympics,53,CPV,Cabo Verde,1,0,0,0,0
26CPV,2004 Summer Olympics,26,CPV,Cabo Verde,2,0,0,0,0
25CPV,2000 Summer Olympics,25,CPV,Cabo Verde,0,0,0,0,0
24CPV,1996 Summer Olympics,24,CPV,Cabo Verde,4,0,0,0,0
61BDI,2020 Summer Olympics,61,BDI,Burundi,4,0,0,0,0
59BDI,2016 Summer Olympics,59,BDI,Burundi,5,0,1,0,1
54BDI,2012 Summer Olympics,54,BDI,Burundi,4,0,0,0,0
53BDI,2008 Summer Olympics,53,BDI,Burundi,1,0,0,0,0
26BDI,2004 Summer Olympics,26,BDI,Burundi,5,0,0,0,0
25BDI,2000 Summer Olympics,25,BDI,Burundi,3,0,0,0,0
24BDI,1996 Summer Olympics,24,BDI,Burundi,7,1,0,0,1
62ARM,2022 Winter Olympics,62,ARM,Armenia,4,0,0,0,0
61ARM,2020 Summer Olympics,61,ARM,Armenia,12,0,2,2,4
60ARM,2018 Winter Olympics,60,ARM,Armenia,2,0,0,0,0
59ARM,2016 Summer Olympics,59,ARM,Armenia,26,1,3,0,4
58ARM,2014 Winter Olympics,58,ARM,Armenia,3,0,0,0,0
54ARM,2012 Summer Olympics,54,ARM,Armenia,14,0,1,1,2
57ARM,2010 Winter Olympics,57,ARM,Armenia,4,0,0,0,0
53ARM,2008 Summer Olympics,53,ARM,Armenia,21,0,1,4,5
49ARM,2006 Winter Olympics,49,ARM,Armenia,5,0,0,0,0
26ARM,2004 Summer Olympics,26,ARM,Armenia,10,0,0,0,0
47ARM,2002 Winter Olympics,47,ARM,Armenia,7,0,0,0,0
25ARM,2000 Summer Olympics,25,ARM,Armenia,17,0,0,1,1
46ARM,1998 Winter Olympics,46,ARM,Armenia,7,0,0,0,0
24ARM,1996 Summer Olympics,24,ARM,Armenia,32,1,1,0,2
45ARM,1994 Winter Olympics,45,ARM,Armenia,2,0,0,0,0
62AZE,2022 Winter Olympics,62,AZE,Azerbaijan,2,0,0,0,0
61AZE,2020 Summer Olympics,61,AZE,Azerbaijan,29,0,3,4,7
60AZE,2018 Winter Olympics,60,AZE,Azerbaijan,0,0,0,0,0
59AZE,2016 Summer Olympics,59,AZE,Azerbaijan,37,1,7,10,18
58AZE,2014 Winter Olympics,58,AZE,Azerbaijan,3,0,0,0,0
54AZE,2012 Summer Olympics,54,AZE,Azerbaijan,38,2,2,5,9
57AZE,2010 Winter Olympics,57,AZE,Azerbaijan,2,0,0,0,0
53AZE,2008 Summer Olympics,53,AZE,Azerbaijan,37,1,1,4,6
49AZE,2006 Winter Olympics,49,AZE,Azerbaijan,0,0,0,0,0
26AZE,2004 Summer Olympics,26,AZE,Azerbaijan,24,1,0,4,5
47AZE,2002 Winter Olympics,47,AZE,Azerbaijan,4,0,0,0,0
25AZE,2000 Summer Olympics,25,AZE,Azerbaijan,23,2,0,1,3
46AZE,1998 Winter Olympics,46,AZE,Azerbaijan,4,0,0,0,0
24AZE,1996 Summer Olympics,24,AZE,Azerbaijan,23,0,1,0,1
61BRU,2020 Summer Olympics,61,BRU,Brunei Darussalam,2,0,0,0,0
59BRU,2016 Summer Olympics,59,BRU,Brunei Darussalam,3,0,0,0,0
54BRU,2012 Summer Olympics,54,BRU,Brunei Darussalam,3,0,0,0,0
26BRU,2004 Summer Olympics,26,BRU,Brunei Darussalam,1,0,0,0,0
25BRU,2000 Summer Olympics,25,BRU,Brunei Darussalam,1,0,0,0,0
24BRU,1996 Summer Olympics,24,BRU,Brunei Darussalam,1,0,0,0,0
61AFG,2020 Summer Olympics,61,AFG,Afghanistan,4,0,0,0,0
59AFG,2016 Summer Olympics,59,AFG,Afghanistan,3,0,0,0,0
54AFG,2012 Summer Olympics,54,AFG,Afghanistan,3,0,0,1,1
53AFG,2008 Summer Olympics,53,AFG,Afghanistan,2,0,0,1,1
26AFG,2004 Summer Olympics,26,AFG,Afghanistan,5,0,0,0,0
24AFG,1996 Summer Olympics,24,AFG,Afghanistan,2,0,0,0,0
22AFG,1988 Summer Olympics,22,AFG,Afghanistan,5,0,0,0,0
20AFG,1980 Summer Olympics,20,AFG,Afghanistan,11,0,0,0,0
18AFG,1972 Summer Olympics,18,AFG,Afghanistan,3,0,0,0,0
17AFG,1968 Summer Olympics,17,AFG,Afghanistan,4,0,0,0,0
16AFG,1964 Summer Olympics,16,AFG,Afghanistan,7,0,0,0,0
15AFG,1960 Summer Olympics,15,AFG,Afghanistan,12,0,0,0,0
14AFG,1956 Summer Olympics,14,AFG,Afghanistan,10,0,0,0,0
12AFG,1948 Summer Olympics,12,AFG,Afghanistan,30,0,0,0,0
11AFG,1936 Summer Olympics,11,AFG,Afghanistan,19,0,0,0,0
61ANG,2020 Summer Olympics,61,ANG,Angola,9,0,0,0,0
59ANG,2016 Summer Olympics,59,ANG,Angola,15,0,0,0,0
54ANG,2012 Summer Olympics,54,ANG,Angola,26,0,0,0,0
53ANG,2008 Summer Olympics,53,ANG,Angola,17,0,0,0,0
26ANG,2004 Summer Olympics,26,ANG,Angola,18,0,0,0,0
25ANG,2000 Summer Olympics,25,ANG,Angola,17,0,0,0,0
24ANG,1996 Summer Olympics,24,ANG,Angola,20,0,0,0,0
23ANG,1992 Summer Olympics,23,ANG,Angola,33,0,0,0,0
22ANG,1988 Summer Olympics,22,ANG,Angola,25,0,0,0,0
20ANG,1980 Summer Olympics,20,ANG,Angola,13,0,0,0,0
62ALB,2022 Winter Olympics,62,ALB,Albania,1,0,0,0,0
61ALB,2020 Summer Olympics,61,ALB,Albania,4,0,0,0,0
60ALB,2018 Winter Olympics,60,ALB,Albania,0,0,0,0,0
59ALB,2016 Summer Olympics,59,ALB,Albania,4,0,0,0,0
58ALB,2014 Winter Olympics,58,ALB,Albania,1,0,0,0,0
54ALB,2012 Summer Olympics,54,ALB,Albania,7,0,0,0,0
57ALB,2010 Winter Olympics,57,ALB,Albania,0,0,0,0,0
53ALB,2008 Summer Olympics,53,ALB,Albania,6,0,0,0,0
49ALB,2006 Winter Olympics,49,ALB,Albania,1,0,0,0,0
26ALB,2004 Summer Olympics,26,ALB,Albania,6,0,0,0,0
25ALB,2000 Summer Olympics,25,ALB,Albania,2,0,0,0,0
24ALB,1996 Summer Olympics,24,ALB,Albania,6,0,0,0,0
23ALB,1992 Summer Olympics,23,ALB,Albania,7,0,0,0,0
18ALB,1972 Summer Olympics,18,ALB,Albania,5,0,0,0,0
61BAR,2020 Summer Olympics,61,BAR,Barbados,5,0,0,0,0
59BAR,2016 Summer Olympics,59,BAR,Barbados,9,0,0,0,0
54BAR,2012 Summer Olympics,54,BAR,Barbados,4,0,0,0,0
53BAR,2008 Summer Olympics,53,BAR,Barbados,6,0,0,0,0
26BAR,2004 Summer Olympics,26,BAR,Barbados,5,0,0,0,0
25BAR,2000 Summer Olympics,25,BAR,Barbados,10,0,0,1,1
24BAR,1996 Summer Olympics,24,BAR,Barbados,11,0,0,0,0
23BAR,1992 Summer Olympics,23,BAR,Barbados,14,0,0,0,0
22BAR,1988 Summer Olympics,22,BAR,Barbados,14,0,0,0,0
21BAR,1984 Summer Olympics,21,BAR,Barbados,15,0,0,0,0
19BAR,1976 Summer Olympics,19,BAR,Barbados,8,0,0,0,0
18BAR,1972 Summer Olympics,18,BAR,Barbados,10,0,0,0,0
17BAR,1968 Summer Olympics,17,BAR,Barbados,10,0,0,0,0
61BIZ,2020 Summer Olympics,61,BIZ,Belize,3,0,0,0,0
59BIZ,2016 Summer Olympics,59,BIZ,Belize,3,0,0,0,0
54BIZ,2012 Summer Olympics,54,BIZ,Belize,3,0,0,0,0
53BIZ,2008 Summer Olympics,53,BIZ,Belize,3,0,0,0,0
26BIZ,2004 Summer Olympics,26,BIZ,Belize,1,0,0,0,0
25BIZ,2000 Summer Olympics,25,BIZ,Belize,2,0,0,0,0
24BIZ,1996 Summer Olympics,24,BIZ,Belize,3,0,0,0,0
23BIZ,1992 Summer Olympics,23,BIZ,Belize,8,0,0,0,0
22BIZ,1988 Summer Olympics,22,BIZ,Belize,8,0,0,0,0
21BIZ,1984 Summer Olympics,21,BIZ,Belize,11,0,0,0,0
19BIZ,1976 Summer Olympics,19,BIZ,Belize,2,0,0,0,0
18BIZ,1972 Summer Olympics,18,BIZ,Belize,1,0,0,0,0
17BIZ,1968 Summer Olympics,17,BIZ,Belize,7,0,0,0,0
61BEN,2020 Summer Olympics,61,BEN,Benin,3,0,0,0,0
59BEN,2016 Summer Olympics,59,BEN,Benin,6,0,0,0,0
54BEN,2012 Summer Olympics,54,BEN,Benin,4,0,0,0,0
53BEN,2008 Summer Olympics,53,BEN,Benin,2,0,0,0,0
26BEN,2004 Summer Olympics,26,BEN,Benin,4,0,0,0,0
25BEN,2000 Summer Olympics,25,BEN,Benin,2,0,0,0,0
24BEN,1996 Summer Olympics,24,BEN,Benin,2,0,0,0,0
23BEN,1992 Summer Olympics,23,BEN,Benin,6,0,0,0,0
22BEN,1988 Summer Olympics,22,BEN,Benin,7,0,0,0,0
21BEN,1984 Summer Olympics,21,BEN,Benin,2,0,0,0,0
20BEN,1980 Summer Olympics,20,BEN,Benin,16,0,0,0,0
18BEN,1972 Summer Olympics,18,BEN,Benin,4,0,0,0,0
61BRN,2020 Summer Olympics,61,BRN,Bahrain,28,0,1,0,1
59BRN,2016 Summer Olympics,59,BRN,Bahrain,32,1,1,0,2
54BRN,2012 Summer Olympics,54,BRN,Bahrain,9,1,0,0,1
53BRN,2008 Summer Olympics,53,BRN,Bahrain,8,0,0,0,0
26BRN,2004 Summer Olympics,26,BRN,Bahrain,10,0,0,0,0
25BRN,2000 Summer Olympics,25,BRN,Bahrain,4,0,0,0,0
24BRN,1996 Summer Olympics,24,BRN,Bahrain,5,0,0,0,0
23BRN,1992 Summer Olympics,23,BRN,Bahrain,9,0,0,0,0
22BRN,1988 Summer Olympics,22,BRN,Bahrain,9,0,0,0,0
21BRN,1984 Summer Olympics,21,BRN,Bahrain,10,0,0,0,0
61ANT,2020 Summer Olympics,61,ANT,Antigua and Barbuda,4,0,0,0,0
59ANT,2016 Summer Olympics,59,ANT,Antigua and Barbuda,8,0,0,0,0
54ANT,2012 Summer Olympics,54,ANT,Antigua and Barbuda,2,0,0,0,0
53ANT,2008 Summer Olympics,53,ANT,Antigua and Barbuda,2,0,0,0,0
26ANT,2004 Summer Olympics,26,ANT,Antigua and Barbuda,4,0,0,0,0
25ANT,2000 Summer Olympics,25,ANT,Antigua and Barbuda,0,0,0,0,0
24ANT,1996 Summer Olympics,24,ANT,Antigua and Barbuda,11,0,0,0,0
23ANT,1992 Summer Olympics,23,ANT,Antigua and Barbuda,11,0,0,0,0
22ANT,1988 Summer Olympics,22,ANT,Antigua and Barbuda,10,0,0,0,0
21ANT,1984 Summer Olympics,21,ANT,Antigua and Barbuda,14,0,0,0,0
19ANT,1976 Summer Olympics,19,ANT,Antigua and Barbuda,10,0,0,0,0
62ASA,2022 Winter Olympics,62,ASA,American Samoa,0,0,0,0,0
61ASA,2020 Summer Olympics,61,ASA,American Samoa,5,0,0,0,0
59ASA,2016 Summer Olympics,59,ASA,American Samoa,4,0,0,0,0
54ASA,2012 Summer Olympics,54,ASA,American Samoa,5,0,0,0,0
53ASA,2008 Summer Olympics,53,ASA,American Samoa,4,0,0,0,0
26ASA,2004 Summer Olympics,26,ASA,American Samoa,1,0,0,0,0
25ASA,2000 Summer Olympics,25,ASA,American Samoa,2,0,0,0,0
24ASA,1996 Summer Olympics,24,ASA,American Samoa,5,0,0,0,0
45ASA,1994 Winter Olympics,45,ASA,American Samoa,2,0,0,0,0
23ASA,1992 Summer Olympics,23,ASA,American Samoa,1,0,0,0,0
22ASA,1988 Summer Olympics,22,ASA,American Samoa,6,0,0,0,0
61BHU,2020 Summer Olympics,61,BHU,Bhutan,2,0,0,0,0
59BHU,2016 Summer Olympics,59,BHU,Bhutan,2,0,0,0,0
54BHU,2012 Summer Olympics,54,BHU,Bhutan,2,0,0,0,0
53BHU,2008 Summer Olympics,53,BHU,Bhutan,1,0,0,0,0
26BHU,2004 Summer Olympics,26,BHU,Bhutan,1,0,0,0,0
25BHU,2000 Summer Olympics,25,BHU,Bhutan,1,0,0,0,0
24BHU,1996 Summer Olympics,24,BHU,Bhutan,1,0,0,0,0
23BHU,1992 Summer Olympics,23,BHU,Bhutan,5,0,0,0,0
22BHU,1988 Summer Olympics,22,BHU,Bhutan,2,0,0,0,0
21BHU,1984 Summer Olympics,21,BHU,Bhutan,6,0,0,0,0
61BAN,2020 Summer Olympics,61,BAN,Bangladesh,5,0,0,0,0
59BAN,2016 Summer Olympics,59,BAN,Bangladesh,6,0,0,0,0
54BAN,2012 Summer Olympics,54,BAN,Bangladesh,5,0,0,0,0
53BAN,2008 Summer Olympics,53,BAN,Bangladesh,4,0,0,0,0
26BAN,2004 Summer Olympics,26,BAN,Bangladesh,3,0,0,0,0
25BAN,2000 Summer Olympics,25,BAN,Bangladesh,5,0,0,0,0
24BAN,1996 Summer Olympics,24,BAN,Bangladesh,4,0,0,0,0
23BAN,1992 Summer Olympics,23,BAN,Bangladesh,4,0,0,0,0
22BAN,1988 Summer Olympics,22,BAN,Bangladesh,6,0,0,0,0
21BAN,1984 Summer Olympics,21,BAN,Bangladesh,1,0,0,0,0
61ARU,2020 Summer Olympics,61,ARU,Aruba,1,0,0,0,0
59ARU,2016 Summer Olympics,59,ARU,Aruba,6,0,0,0,0
54ARU,2012 Summer Olympics,54,ARU,Aruba,4,0,0,0,0
53ARU,2008 Summer Olympics,53,ARU,Aruba,2,0,0,0,0
26ARU,2004 Summer Olympics,26,ARU,Aruba,1,0,0,0,0
25ARU,2000 Summer Olympics,25,ARU,Aruba,5,0,0,0,0
24ARU,1996 Summer Olympics,24,ARU,Aruba,2,0,0,0,0
23ARU,1992 Summer Olympics,23,ARU,Aruba,4,0,0,0,0
22ARU,1988 Summer Olympics,22,ARU,Aruba,8,0,0,0,0
6BOH,1912 Summer Olympics,6,BOH,Bohemia,44,0,0,0,0
5BOH,1908 Summer Olympics,5,BOH,Bohemia,26,0,0,6,6
2BOH,1900 Summer Olympics,2,BOH,Bohemia,11,0,1,3,4
6ANZ,1912 Summer Olympics,6,ANZ,Australasia,24,5,2,3,10
5ANZ,1908 Summer Olympics,5,ANZ,Australasia,47,31,2,2,35
